MODE 2
SIZE 11/70
LIMIT 0/40
COLOR LIMIT 4
STARS 1000/1500/2000
POWERUPS 0/0/0/0
0 11 6 6 6 6 6 6 6 11 0
0 6 6 12 0 0 12 6 6 0 0
0 0 0 0 6 6 6 0 0 0 0
0 0 0 0 14 14 0 0 0 0 0
0 0 0 6 6 6 6 6 0 0 0
0 0 0 0 6 6 0 0 0 0 0
0 0 0 0 0 15 0 0 0 0 0
0 0 0 6 6 6 6 0 0 0 0
0 0 0 0 6 0 6 0 0 0 0
0 0 0 0 16 16 0 0 0 0 0
0 0 0 0 6 0 6 0 0 0 0
0 0 6 6 0 0 6 6 0 0 0
0 0 0 6 0 0 0 6 0 0 0
0 0 6 0 0 0 0 6 0 0 0
0 0 0 6 0 0 0 6 0 0 0
0 0 6 0 0 0 0 6 0 0 0
0 0 0 6 0 0 0 6 0 0 0
0 0 6 0 0 0 0 6 0 0 0
0 0 6 6 0 0 0 6 6 0 0
0 0 6 0 0 0 0 6 0 0 0
0 0 6 6 0 0 0 6 6 0 0
0 6 6 0 0 0 0 6 6 0 0
0 6 0 6 0 0 0 6 0 6 0
6 6 6 6 0 0 6 6 6 6 0
0 0 6 0 0 0 0 0 6 0 0
0 0 0 0 0 0 0 0 0 0 0
0 0 0 0 0 0 0 0 0 0 0
0 0 0 0 0 0 0 0 0 0 0
0 0 0 0 0 0 0 0 0 0 0
0 0 0 0 0 0 0 0 0 0 0
0 0 0 0 0 0 0 0 0 0 0
0 0 0 0 0 0 0 0 0 0 0
0 0 0 0 0 0 0 0 0 0 0
0 0 0 0 0 0 0 0 0 0 0
0 0 0 0 0 0 0 0 0 0 0
0 0 0 0 0 0 0 0 0 0 0
0 0 0 0 0 0 0 0 0 0 0
0 0 0 0 0 0 0 0 0 0 0
0 0 0 0 0 0 0 0 0 0 0
0 0 0 0 0 0 0 0 0 0 0
0 0 0 0 0 0 0 0 0 0 0
0 0 0 0 0 0 0 0 0 0 0
0 0 0 0 0 0 0 0 0 0 0
0 0 0 0 0 0 0 0 0 0 0
0 0 0 0 0 0 0 0 0 0 0
0 0 0 0 0 0 0 0 0 0 0
0 0 0 0 0 0 0 0 0 0 0
0 0 0 0 0 0 0 0 0 0 0
0 0 0 0 0 0 0 0 0 0 0
0 0 0 0 0 0 0 0 0 0 0
0 0 0 0 0 0 0 0 0 0 0
0 0 0 0 0 0 0 0 0 0 0
0 0 0 0 0 0 0 0 0 0 0
0 0 0 0 0 0 0 0 0 0 0
0 0 0 0 0 0 0 0 0 0 0
0 0 0 0 0 0 0 0 0 0 0
0 0 0 0 0 0 0 0 0 0 0
0 0 0 0 0 0 0 0 0 0 0
0 0 0 0 0 0 0 0 0 0 0
0 0 0 0 0 0 0 0 0 0 0
0 0 0 0 0 0 0 0 0 0 0
0 0 0 0 0 0 0 0 0 0 0
0 0 0 0 0 0 0 0 0 0 0
0 0 0 0 0 0 0 0 0 0 0
0 0 0 0 0 0 0 0 0 0 0
0 0 0 0 0 0 0 0 0 0 0
0 0 0 0 0 0 0 0 0 0 0
0 0 0 0 0 0 0 0 0 0 0
0 0 0 0 0 0 0 0 0 0 0
0 0 0 0 0 0 0 0 0 0 0