MODE 2
SIZE 11/70
LIMIT 0/40
COLOR LIMIT 4
STARS 1500/2000/3000
POWERUPS 0/0/0/0
0 0 13 13 2 2 2 13 13 0 0
0 0 7 7 7 7 7 7 0 0 0
0 0 0 7 3 7 3 7 0 0 0
0 0 0 7 3 3 7 0 0 0 0
0 0 17 16 16 17 16 16 17 0 0
0 0 17 7 17 17 7 17 0 0 0
0 0 0 18 3 3 3 18 0 0 0
0 0 0 18 18 18 18 0 0 0 0
0 0 0 0 2 2 2 0 0 0 0
0 0 0 11 12 12 11 0 0 0 0
0 0 0 1 0 0 0 1 0 0 0
0 0 1 1 0 0 1 1 0 0 0
0 0 1 1 1 0 1 1 1 0 0
0 0 0 16 5 5 16 0 0 0 0
0 0 0 0 7 5 7 0 0 0 0
0 0 0 0 16 16 0 0 0 0 0
0 0 0 0 7 0 7 0 0 0 0
0 0 0 7 0 0 7 0 0 0 0
0 0 0 7 0 0 0 7 0 0 0
7 7 7 0 0 0 0 7 7 7 0
0 7 7 0 0 0 0 0 7 7 0
0 0 7 7 0 0 0 7 7 0 0
0 0 0 7 0 0 0 7 0 0 0
0 0 0 0 0 0 0 0 0 0 0
0 0 0 0 0 0 0 0 0 0 0
0 0 0 0 0 0 0 0 0 0 0
0 0 0 0 0 0 0 0 0 0 0
0 0 0 0 0 0 0 0 0 0 0
0 0 0 0 0 0 0 0 0 0 0
0 0 0 0 0 0 0 0 0 0 0
0 0 0 0 0 0 0 0 0 0 0
0 0 0 0 0 0 0 0 0 0 0
0 0 0 0 0 0 0 0 0 0 0
0 0 0 0 0 0 0 0 0 0 0
0 0 0 0 0 0 0 0 0 0 0
0 0 0 0 0 0 0 0 0 0 0
0 0 0 0 0 0 0 0 0 0 0
0 0 0 0 0 0 0 0 0 0 0
0 0 0 0 0 0 0 0 0 0 0
0 0 0 0 0 0 0 0 0 0 0
0 0 0 0 0 0 0 0 0 0 0
0 0 0 0 0 0 0 0 0 0 0
0 0 0 0 0 0 0 0 0 0 0
0 0 0 0 0 0 0 0 0 0 0
0 0 0 0 0 0 0 0 0 0 0
0 0 0 0 0 0 0 0 0 0 0
0 0 0 0 0 0 0 0 0 0 0
0 0 0 0 0 0 0 0 0 0 0
0 0 0 0 0 0 0 0 0 0 0
0 0 0 0 0 0 0 0 0 0 0
0 0 0 0 0 0 0 0 0 0 0
0 0 0 0 0 0 0 0 0 0 0
0 0 0 0 0 0 0 0 0 0 0
0 0 0 0 0 0 0 0 0 0 0
0 0 0 0 0 0 0 0 0 0 0
0 0 0 0 0 0 0 0 0 0 0
0 0 0 0 0 0 0 0 0 0 0
0 0 0 0 0 0 0 0 0 0 0
0 0 0 0 0 0 0 0 0 0 0
0 0 0 0 0 0 0 0 0 0 0
0 0 0 0 0 0 0 0 0 0 0
0 0 0 0 0 0 0 0 0 0 0
0 0 0 0 0 0 0 0 0 0 0
0 0 0 0 0 0 0 0 0 0 0
0 0 0 0 0 0 0 0 0 0 0
0 0 0 0 0 0 0 0 0 0 0
0 0 0 0 0 0 0 0 0 0 0
0 0 0 0 0 0 0 0 0 0 0
0 0 0 0 0 0 0 0 0 0 0
0 0 0 0 0 0 0 0 0 0 0