MODE 2
SIZE 11/70
LIMIT 0/41
COLOR LIMIT 4
STARS 1500/2000/3000
POWERUPS 0/0/0/0
0 0 13 0 0 14 0 0 15 0 0
0 7 7 0 7 7 0 7 7 0 0
0 0 16 0 3 7 3 0 16 0 0
0 7 7 0 3 3 0 7 7 0 0
0 0 7 0 5 3 5 0 7 0 0
0 7 7 0 5 5 0 7 7 0 0
0 0 11 0 6 5 6 0 11 0 0
0 7 7 0 6 6 0 7 7 0 0
0 0 12 0 2 6 2 0 12 0 0
0 7 7 0 2 2 0 7 7 0 0
0 0 7 0 1 2 1 0 7 0 0
0 7 7 7 1 1 7 7 7 0 0
0 0 0 0 7 1 7 0 0 0 0
0 0 0 0 7 7 0 0 0 0 0
0 0 0 0 0 7 0 0 0 0 0
0 0 0 5 2 2 5 0 0 0 0
0 0 0 0 2 2 2 0 0 0 0
0 0 0 2 1 1 2 0 0 0 0
0 0 6 6 1 1 1 6 6 0 0
0 0 6 0 1 1 0 6 0 0 0
0 0 6 0 0 0 0 0 6 0 0
0 6 6 5 0 0 5 6 6 0 0
0 0 0 5 0 0 0 5 0 0 0
0 0 5 0 0 0 0 5 0 0 0
0 0 5 7 0 0 0 7 5 0 0
0 5 7 0 0 0 0 7 5 0 0
0 5 7 0 0 0 0 0 7 5 0
0 0 0 0 0 0 0 0 0 0 0
0 0 0 0 0 0 0 0 0 0 0
0 0 0 0 0 0 0 0 0 0 0
0 0 0 0 0 0 0 0 0 0 0
0 0 0 0 0 0 0 0 0 0 0
0 0 0 0 0 0 0 0 0 0 0
0 0 0 0 0 0 0 0 0 0 0
0 0 0 0 0 0 0 0 0 0 0
0 0 0 0 0 0 0 0 0 0 0
0 0 0 0 0 0 0 0 0 0 0
0 0 0 0 0 0 0 0 0 0 0
0 0 0 0 0 0 0 0 0 0 0
0 0 0 0 0 0 0 0 0 0 0
0 0 0 0 0 0 0 0 0 0 0
0 0 0 0 0 0 0 0 0 0 0
0 0 0 0 0 0 0 0 0 0 0
0 0 0 0 0 0 0 0 0 0 0
0 0 0 0 0 0 0 0 0 0 0
0 0 0 0 0 0 0 0 0 0 0
0 0 0 0 0 0 0 0 0 0 0
0 0 0 0 0 0 0 0 0 0 0
0 0 0 0 0 0 0 0 0 0 0
0 0 0 0 0 0 0 0 0 0 0
0 0 0 0 0 0 0 0 0 0 0
0 0 0 0 0 0 0 0 0 0 0
0 0 0 0 0 0 0 0 0 0 0
0 0 0 0 0 0 0 0 0 0 0
0 0 0 0 0 0 0 0 0 0 0
0 0 0 0 0 0 0 0 0 0 0
0 0 0 0 0 0 0 0 0 0 0
0 0 0 0 0 0 0 0 0 0 0
0 0 0 0 0 0 0 0 0 0 0
0 0 0 0 0 0 0 0 0 0 0
0 0 0 0 0 0 0 0 0 0 0
0 0 0 0 0 0 0 0 0 0 0
0 0 0 0 0 0 0 0 0 0 0
0 0 0 0 0 0 0 0 0 0 0
0 0 0 0 0 0 0 0 0 0 0
0 0 0 0 0 0 0 0 0 0 0
0 0 0 0 0 0 0 0 0 0 0
0 0 0 0 0 0 0 0 0 0 0
0 0 0 0 0 0 0 0 0 0 0
0 0 0 0 0 0 0 0 0 0 0