MODE 2
SIZE 11/70
LIMIT 0/35
COLOR LIMIT 4
STARS 1500/2000/3000
POWERUPS 0/0/0/0
0 0 7 7 0 15 15 0 7 7 0
0 0 13 0 0 7 0 0 13 0 0
0 0 0 7 0 7 7 0 7 0 0
0 0 1 16 0 16 0 16 1 0 0
0 0 0 1 7 0 0 7 1 0 0
0 0 0 1 12 0 12 1 0 0 0
0 0 0 0 1 0 0 1 0 0 0
0 0 2 1 2 0 2 1 2 0 0
0 0 2 1 2 0 0 2 1 2 0
0 2 1 2 0 0 0 2 1 2 0
0 0 2 2 0 0 0 0 2 2 0
0 0 3 3 0 0 0 3 3 0 0
0 0 3 3 0 0 0 0 3 3 0
0 0 3 4 0 0 0 4 3 0 0
0 0 0 4 0 0 0 0 4 0 0
0 0 4 4 4 4 4 4 4 0 0
0 0 4 5 5 5 5 5 5 4 0
0 0 0 5 5 5 5 5 0 0 0
0 0 0 0 5 5 5 5 0 0 0
0 0 0 0 5 5 5 0 0 0 0
0 0 0 0 0 5 5 0 0 0 0
0 0 0 0 6 5 6 0 0 0 0
0 0 6 6 6 0 0 6 6 6 0
0 0 0 0 0 0 0 0 0 0 0
0 0 0 0 0 0 0 0 0 0 0
0 0 0 0 0 0 0 0 0 0 0
0 0 0 0 0 0 0 0 0 0 0
0 0 0 0 0 0 0 0 0 0 0
0 0 0 0 0 0 0 0 0 0 0
0 0 0 0 0 0 0 0 0 0 0
0 0 0 0 0 0 0 0 0 0 0
0 0 0 0 0 0 0 0 0 0 0
0 0 0 0 0 0 0 0 0 0 0
0 0 0 0 0 0 0 0 0 0 0
0 0 0 0 0 0 0 0 0 0 0
0 0 0 0 0 0 0 0 0 0 0
0 0 0 0 0 0 0 0 0 0 0
0 0 0 0 0 0 0 0 0 0 0
0 0 0 0 0 0 0 0 0 0 0
0 0 0 0 0 0 0 0 0 0 0
0 0 0 0 0 0 0 0 0 0 0
0 0 0 0 0 0 0 0 0 0 0
0 0 0 0 0 0 0 0 0 0 0
0 0 0 0 0 0 0 0 0 0 0
0 0 0 0 0 0 0 0 0 0 0
0 0 0 0 0 0 0 0 0 0 0
0 0 0 0 0 0 0 0 0 0 0
0 0 0 0 0 0 0 0 0 0 0
0 0 0 0 0 0 0 0 0 0 0
0 0 0 0 0 0 0 0 0 0 0
0 0 0 0 0 0 0 0 0 0 0
0 0 0 0 0 0 0 0 0 0 0
0 0 0 0 0 0 0 0 0 0 0
0 0 0 0 0 0 0 0 0 0 0
0 0 0 0 0 0 0 0 0 0 0
0 0 0 0 0 0 0 0 0 0 0
0 0 0 0 0 0 0 0 0 0 0
0 0 0 0 0 0 0 0 0 0 0
0 0 0 0 0 0 0 0 0 0 0
0 0 0 0 0 0 0 0 0 0 0
0 0 0 0 0 0 0 0 0 0 0
0 0 0 0 0 0 0 0 0 0 0
0 0 0 0 0 0 0 0 0 0 0
0 0 0 0 0 0 0 0 0 0 0
0 0 0 0 0 0 0 0 0 0 0
0 0 0 0 0 0 0 0 0 0 0
0 0 0 0 0 0 0 0 0 0 0
0 0 0 0 0 0 0 0 0 0 0
0 0 0 0 0 0 0 0 0 0 0
0 0 0 0 0 0 0 0 0 0 0