MODE 2
SIZE 11/70
LIMIT 0/30
COLOR LIMIT 4
STARS 500/1500/3000
POWERUPS 0/0/0/0
0 0 12 12 12 18 12 12 12 0 0
0 12 18 18 18 18 18 18 12 0 0
0 12 18 17 17 17 17 17 18 12 0
18 18 17 17 10 10 17 17 18 18 0
17 17 17 7 7 7 7 7 17 17 17
0 8 0 7 7 7 7 0 8 0 0
0 0 0 0 7 7 7 0 0 0 0
7 7 7 7 9 9 7 7 7 7 0
0 0 0 0 7 7 7 0 0 0 0
0 0 0 7 7 7 7 0 0 0 0
0 6 6 7 7 7 7 7 6 6 0
0 6 6 0 0 0 0 6 6 0 0
0 0 5 5 0 0 0 5 5 0 0
0 5 5 0 0 0 0 5 5 0 0
0 0 4 4 0 0 0 4 4 0 0
0 0 4 4 0 0 4 4 0 0 0
0 0 3 3 0 0 0 3 3 0 0
0 3 3 0 0 0 0 3 3 0 0
0 0 2 2 0 0 0 2 2 0 0
0 0 2 2 0 0 2 2 0 0 0
0 18 1 1 18 0 18 1 1 18 0
18 1 1 18 0 0 18 1 1 18 0
0 18 18 18 0 0 0 18 18 18 0
0 0 0 0 0 0 0 0 0 0 0
0 0 0 0 0 0 0 0 0 0 0
0 0 0 0 0 0 0 0 0 0 0
0 0 0 0 0 0 0 0 0 0 0
0 0 0 0 0 0 0 0 0 0 0
0 0 0 0 0 0 0 0 0 0 0
0 0 0 0 0 0 0 0 0 0 0
0 0 0 0 0 0 0 0 0 0 0
0 0 0 0 0 0 0 0 0 0 0
0 0 0 0 0 0 0 0 0 0 0
0 0 0 0 0 0 0 0 0 0 0
0 0 0 0 0 0 0 0 0 0 0
0 0 0 0 0 0 0 0 0 0 0
0 0 0 0 0 0 0 0 0 0 0
0 0 0 0 0 0 0 0 0 0 0
0 0 0 0 0 0 0 0 0 0 0
0 0 0 0 0 0 0 0 0 0 0
0 0 0 0 0 0 0 0 0 0 0
0 0 0 0 0 0 0 0 0 0 0
0 0 0 0 0 0 0 0 0 0 0
0 0 0 0 0 0 0 0 0 0 0
0 0 0 0 0 0 0 0 0 0 0
0 0 0 0 0 0 0 0 0 0 0
0 0 0 0 0 0 0 0 0 0 0
0 0 0 0 0 0 0 0 0 0 0
0 0 0 0 0 0 0 0 0 0 0
0 0 0 0 0 0 0 0 0 0 0
0 0 0 0 0 0 0 0 0 0 0
0 0 0 0 0 0 0 0 0 0 0
0 0 0 0 0 0 0 0 0 0 0
0 0 0 0 0 0 0 0 0 0 0
0 0 0 0 0 0 0 0 0 0 0
0 0 0 0 0 0 0 0 0 0 0
0 0 0 0 0 0 0 0 0 0 0
0 0 0 0 0 0 0 0 0 0 0
0 0 0 0 0 0 0 0 0 0 0
0 0 0 0 0 0 0 0 0 0 0
0 0 0 0 0 0 0 0 0 0 0
0 0 0 0 0 0 0 0 0 0 0
0 0 0 0 0 0 0 0 0 0 0
0 0 0 0 0 0 0 0 0 0 0
0 0 0 0 0 0 0 0 0 0 0
0 0 0 0 0 0 0 0 0 0 0
0 0 0 0 0 0 0 0 0 0 0
0 0 0 0 0 0 0 0 0 0 0
0 0 0 0 0 0 0 0 0 0 0
0 0 0 0 0 0 0 0 0 0 0