MODE 2
SIZE 11/70
LIMIT 0/30
COLOR LIMIT 4
STARS 500/1500/4600
POWERUPS 0/0/0/0
0 12 14 14 14 13 13 14 14 14 12
0 18 14 14 18 13 18 14 14 18 0
0 0 18 18 18 0 0 18 18 18 0
0 1 1 1 0 2 0 1 1 1 0
0 0 1 1 0 2 2 0 1 1 0
0 0 1 0 2 2 2 0 1 0 0
0 0 3 3 0 4 4 0 5 5 0
0 3 3 3 0 4 0 5 5 5 0
0 0 6 6 0 4 4 0 1 1 0
0 0 6 0 0 4 0 0 1 0 0
0 0 6 6 0 4 4 0 1 1 0
0 0 6 0 0 6 0 0 1 0 0
0 0 6 6 0 6 6 0 1 1 0
0 6 6 6 0 6 0 6 6 6 0
0 0 6 6 0 6 6 0 6 6 0
0 0 6 0 0 6 0 0 6 0 0
0 0 6 6 0 6 6 0 6 6 0
0 0 6 0 0 6 0 0 6 0 0
0 0 6 6 0 6 6 0 6 6 0
0 16 16 16 16 16 16 16 16 16 0
0 0 18 18 18 18 18 18 18 18 0
0 0 0 0 0 0 0 0 0 0 0
0 0 0 0 0 0 0 0 0 0 0
0 0 0 0 0 0 0 0 0 0 0
0 0 0 0 0 0 0 0 0 0 0
0 0 0 0 0 0 0 0 0 0 0
0 0 0 0 0 0 0 0 0 0 0
0 0 0 0 0 0 0 0 0 0 0
0 0 0 0 0 0 0 0 0 0 0
0 0 0 0 0 0 0 0 0 0 0
0 0 0 0 0 0 0 0 0 0 0
0 0 0 0 0 0 0 0 0 0 0
0 0 0 0 0 0 0 0 0 0 0
0 0 0 0 0 0 0 0 0 0 0
0 0 0 0 0 0 0 0 0 0 0
0 0 0 0 0 0 0 0 0 0 0
0 0 0 0 0 0 0 0 0 0 0
0 0 0 0 0 0 0 0 0 0 0
0 0 0 0 0 0 0 0 0 0 0
0 0 0 0 0 0 0 0 0 0 0
0 0 0 0 0 0 0 0 0 0 0
0 0 0 0 0 0 0 0 0 0 0
0 0 0 0 0 0 0 0 0 0 0
0 0 0 0 0 0 0 0 0 0 0
0 0 0 0 0 0 0 0 0 0 0
0 0 0 0 0 0 0 0 0 0 0
0 0 0 0 0 0 0 0 0 0 0
0 0 0 0 0 0 0 0 0 0 0
0 0 0 0 0 0 0 0 0 0 0
0 0 0 0 0 0 0 0 0 0 0
0 0 0 0 0 0 0 0 0 0 0
0 0 0 0 0 0 0 0 0 0 0
0 0 0 0 0 0 0 0 0 0 0
0 0 0 0 0 0 0 0 0 0 0
0 0 0 0 0 0 0 0 0 0 0
0 0 0 0 0 0 0 0 0 0 0
0 0 0 0 0 0 0 0 0 0 0
0 0 0 0 0 0 0 0 0 0 0
0 0 0 0 0 0 0 0 0 0 0
0 0 0 0 0 0 0 0 0 0 0
0 0 0 0 0 0 0 0 0 0 0
0 0 0 0 0 0 0 0 0 0 0
0 0 0 0 0 0 0 0 0 0 0
0 0 0 0 0 0 0 0 0 0 0
0 0 0 0 0 0 0 0 0 0 0
0 0 0 0 0 0 0 0 0 0 0
0 0 0 0 0 0 0 0 0 0 0
0 0 0 0 0 0 0 0 0 0 0
0 0 0 0 0 0 0 0 0 0 0
0 0 0 0 0 0 0 0 0 0 0