MODE 2
SIZE 11/70
LIMIT 0/25
COLOR LIMIT 4
STARS 500/1500/4600
POWERUPS 0/0/0/0
0 0 11 11 12 12 14 14 13 13 0
0 17 17 18 18 18 18 18 17 17 0
0 0 0 0 15 3 3 15 0 0 0
0 0 0 15 3 3 3 15 0 0 0
0 0 7 7 0 7 7 0 7 7 0
0 0 7 0 0 7 0 0 7 0 0
0 0 7 7 0 7 7 0 7 7 0
0 0 7 0 0 7 0 0 7 0 0
0 0 7 7 0 7 7 0 7 7 0
0 0 7 0 0 7 0 0 7 0 0
0 0 7 7 0 7 7 0 7 7 0
0 0 7 0 0 7 0 0 7 0 0
0 0 7 7 0 7 7 0 7 7 0
0 0 7 0 0 7 0 0 7 0 0
0 0 7 7 0 7 7 0 7 7 0
0 0 7 0 0 7 0 0 7 0 0
0 0 7 7 0 7 7 0 7 7 0
0 0 7 0 0 7 0 0 7 0 0
0 0 1 1 0 1 1 0 1 1 0
0 0 1 0 0 1 0 0 1 0 0
0 0 3 3 0 3 3 0 3 3 0
0 0 3 0 0 3 0 0 3 0 0
0 0 6 6 0 6 6 0 6 6 0
0 0 6 0 0 6 0 0 6 0 0
0 0 18 18 0 18 18 0 18 18 0
0 0 18 0 0 18 0 0 18 0 0
0 0 0 0 0 0 0 0 0 0 0
0 0 0 0 0 0 0 0 0 0 0
0 0 0 0 0 0 0 0 0 0 0
0 0 0 0 0 0 0 0 0 0 0
0 0 0 0 0 0 0 0 0 0 0
0 0 0 0 0 0 0 0 0 0 0
0 0 0 0 0 0 0 0 0 0 0
0 0 0 0 0 0 0 0 0 0 0
0 0 0 0 0 0 0 0 0 0 0
0 0 0 0 0 0 0 0 0 0 0
0 0 0 0 0 0 0 0 0 0 0
0 0 0 0 0 0 0 0 0 0 0
0 0 0 0 0 0 0 0 0 0 0
0 0 0 0 0 0 0 0 0 0 0
0 0 0 0 0 0 0 0 0 0 0
0 0 0 0 0 0 0 0 0 0 0
0 0 0 0 0 0 0 0 0 0 0
0 0 0 0 0 0 0 0 0 0 0
0 0 0 0 0 0 0 0 0 0 0
0 0 0 0 0 0 0 0 0 0 0
0 0 0 0 0 0 0 0 0 0 0
0 0 0 0 0 0 0 0 0 0 0
0 0 0 0 0 0 0 0 0 0 0
0 0 0 0 0 0 0 0 0 0 0
0 0 0 0 0 0 0 0 0 0 0
0 0 0 0 0 0 0 0 0 0 0
0 0 0 0 0 0 0 0 0 0 0
0 0 0 0 0 0 0 0 0 0 0
0 0 0 0 0 0 0 0 0 0 0
0 0 0 0 0 0 0 0 0 0 0
0 0 0 0 0 0 0 0 0 0 0
0 0 0 0 0 0 0 0 0 0 0
0 0 0 0 0 0 0 0 0 0 0
0 0 0 0 0 0 0 0 0 0 0
0 0 0 0 0 0 0 0 0 0 0
0 0 0 0 0 0 0 0 0 0 0
0 0 0 0 0 0 0 0 0 0 0
0 0 0 0 0 0 0 0 0 0 0
0 0 0 0 0 0 0 0 0 0 0
0 0 0 0 0 0 0 0 0 0 0
0 0 0 0 0 0 0 0 0 0 0
0 0 0 0 0 0 0 0 0 0 0
0 0 0 0 0 0 0 0 0 0 0
0 0 0 0 0 0 0 0 0 0 0