MODE 2
SIZE 11/70
LIMIT 0/40
COLOR LIMIT 4
STARS 500/1500/4600
POWERUPS 0/0/0/0
0 6 6 6 6 6 6 6 6 6 0
6 1 14 1 1 15 1 12 1 6 0
0 6 5 5 5 16 5 5 5 6 0
0 6 6 6 16 16 6 6 6 0 0
0 0 6 6 16 0 16 6 6 0 0
3 3 6 16 0 0 16 6 3 3 0
3 3 6 16 0 0 0 16 6 3 3
3 6 16 16 16 16 16 16 6 3 0
6 6 16 0 0 0 0 0 16 6 6
6 16 0 0 0 0 0 0 16 6 0
6 6 0 0 0 0 0 0 0 6 6
6 6 6 6 6 6 6 6 6 6 6
0 6 3 3 3 6 4 4 4 6 0
6 3 3 3 6 4 4 4 6 0 0
0 6 5 5 5 6 6 6 6 6 0
6 5 5 5 6 6 6 6 6 0 0
0 6 5 5 5 6 6 6 6 6 0
6 1 1 1 6 2 2 2 6 0 0
0 6 1 1 1 6 2 2 2 6 0
6 1 1 1 6 2 2 2 6 0 0
6 6 6 6 6 6 6 6 6 6 6
5 5 5 5 5 5 5 5 5 5 0
0 0 0 0 0 0 0 0 0 0 0
0 0 0 0 0 0 0 0 0 0 0
0 0 0 0 0 0 0 0 0 0 0
0 0 0 0 0 0 0 0 0 0 0
0 0 0 0 0 0 0 0 0 0 0
0 0 0 0 0 0 0 0 0 0 0
0 0 0 0 0 0 0 0 0 0 0
0 0 0 0 0 0 0 0 0 0 0
0 0 0 0 0 0 0 0 0 0 0
0 0 0 0 0 0 0 0 0 0 0
0 0 0 0 0 0 0 0 0 0 0
0 0 0 0 0 0 0 0 0 0 0
0 0 0 0 0 0 0 0 0 0 0
0 0 0 0 0 0 0 0 0 0 0
0 0 0 0 0 0 0 0 0 0 0
0 0 0 0 0 0 0 0 0 0 0
0 0 0 0 0 0 0 0 0 0 0
0 0 0 0 0 0 0 0 0 0 0
0 0 0 0 0 0 0 0 0 0 0
0 0 0 0 0 0 0 0 0 0 0
0 0 0 0 0 0 0 0 0 0 0
0 0 0 0 0 0 0 0 0 0 0
0 0 0 0 0 0 0 0 0 0 0
0 0 0 0 0 0 0 0 0 0 0
0 0 0 0 0 0 0 0 0 0 0
0 0 0 0 0 0 0 0 0 0 0
0 0 0 0 0 0 0 0 0 0 0
0 0 0 0 0 0 0 0 0 0 0
0 0 0 0 0 0 0 0 0 0 0
0 0 0 0 0 0 0 0 0 0 0
0 0 0 0 0 0 0 0 0 0 0
0 0 0 0 0 0 0 0 0 0 0
0 0 0 0 0 0 0 0 0 0 0
0 0 0 0 0 0 0 0 0 0 0
0 0 0 0 0 0 0 0 0 0 0
0 0 0 0 0 0 0 0 0 0 0
0 0 0 0 0 0 0 0 0 0 0
0 0 0 0 0 0 0 0 0 0 0
0 0 0 0 0 0 0 0 0 0 0
0 0 0 0 0 0 0 0 0 0 0
0 0 0 0 0 0 0 0 0 0 0
0 0 0 0 0 0 0 0 0 0 0
0 0 0 0 0 0 0 0 0 0 0
0 0 0 0 0 0 0 0 0 0 0
0 0 0 0 0 0 0 0 0 0 0
0 0 0 0 0 0 0 0 0 0 0
0 0 0 0 0 0 0 0 0 0 0
0 0 0 0 0 0 0 0 0 0 0