MODE 2
SIZE 11/70
LIMIT 0/18
COLOR LIMIT 4
STARS 500/1500/3000
POWERUPS 0/0/0/0
0 0 16 15 18 0 18 15 16 0 0
0 16 16 15 18 18 15 16 16 0 0
0 14 14 14 14 18 14 14 14 14 0
0 13 13 13 18 18 13 13 13 0 0
0 0 18 18 18 18 18 18 18 0 0
0 1 1 0 0 0 0 1 1 0 0
0 0 1 2 0 0 0 2 1 0 0
0 1 1 2 0 0 2 1 1 0 0
0 3 3 2 0 0 0 2 3 3 0
0 3 3 4 0 0 4 3 3 0 0
0 4 4 4 5 0 5 4 4 4 0
0 5 5 5 0 0 5 5 5 0 0
0 6 6 6 0 0 0 6 6 6 0
0 6 6 0 0 0 0 6 6 0 0
0 0 6 0 0 0 0 0 6 0 0
0 7 7 7 0 0 0 7 7 7 0
0 0 7 7 0 0 0 0 7 7 0
0 0 7 0 0 0 0 0 7 0 0
0 0 7 7 0 0 0 0 7 7 0
0 7 7 7 0 0 0 7 7 7 0
0 0 0 7 0 0 0 0 7 0 0
0 0 0 7 0 0 0 7 0 0 0
0 0 0 0 7 0 0 7 0 0 0
0 7 7 7 0 0 0 7 7 7 0
0 0 7 7 0 0 0 0 7 7 0
0 7 7 7 0 0 0 7 7 7 0
0 0 0 0 0 0 0 0 0 0 0
0 0 0 0 0 0 0 0 0 0 0
0 0 0 0 0 0 0 0 0 0 0
0 0 0 0 0 0 0 0 0 0 0
0 0 0 0 0 0 0 0 0 0 0
0 0 0 0 0 0 0 0 0 0 0
0 0 0 0 0 0 0 0 0 0 0
0 0 0 0 0 0 0 0 0 0 0
0 0 0 0 0 0 0 0 0 0 0
0 0 0 0 0 0 0 0 0 0 0
0 0 0 0 0 0 0 0 0 0 0
0 0 0 0 0 0 0 0 0 0 0
0 0 0 0 0 0 0 0 0 0 0
0 0 0 0 0 0 0 0 0 0 0
0 0 0 0 0 0 0 0 0 0 0
0 0 0 0 0 0 0 0 0 0 0
0 0 0 0 0 0 0 0 0 0 0
0 0 0 0 0 0 0 0 0 0 0
0 0 0 0 0 0 0 0 0 0 0
0 0 0 0 0 0 0 0 0 0 0
0 0 0 0 0 0 0 0 0 0 0
0 0 0 0 0 0 0 0 0 0 0
0 0 0 0 0 0 0 0 0 0 0
0 0 0 0 0 0 0 0 0 0 0
0 0 0 0 0 0 0 0 0 0 0
0 0 0 0 0 0 0 0 0 0 0
0 0 0 0 0 0 0 0 0 0 0
0 0 0 0 0 0 0 0 0 0 0
0 0 0 0 0 0 0 0 0 0 0
0 0 0 0 0 0 0 0 0 0 0
0 0 0 0 0 0 0 0 0 0 0
0 0 0 0 0 0 0 0 0 0 0
0 0 0 0 0 0 0 0 0 0 0
0 0 0 0 0 0 0 0 0 0 0
0 0 0 0 0 0 0 0 0 0 0
0 0 0 0 0 0 0 0 0 0 0
0 0 0 0 0 0 0 0 0 0 0
0 0 0 0 0 0 0 0 0 0 0
0 0 0 0 0 0 0 0 0 0 0
0 0 0 0 0 0 0 0 0 0 0
0 0 0 0 0 0 0 0 0 0 0
0 0 0 0 0 0 0 0 0 0 0
0 0 0 0 0 0 0 0 0 0 0
0 0 0 0 0 0 0 0 0 0 0