MODE 2
SIZE 11/70
LIMIT 0/25
COLOR LIMIT 4
STARS 500/1500/3000
POWERUPS 0/0/0/0
0 0 13 13 14 14 15 15 16 16 0
0 0 6 6 6 6 6 6 6 0 0
0 0 6 11 11 6 6 12 12 6 0
0 0 6 11 6 6 6 12 6 0 0
0 0 6 0 8 6 6 8 0 6 0
0 0 6 0 6 6 6 0 6 0 0
0 0 0 6 0 6 6 0 6 0 0
0 0 0 6 0 8 0 6 0 0 0
0 0 0 0 6 0 0 6 0 0 0
0 0 0 0 6 0 6 0 0 0 0
0 0 0 0 0 6 6 0 0 0 0
0 0 6 6 6 6 6 6 6 0 0
0 0 0 6 6 0 0 6 6 0 0
0 0 0 6 0 0 0 6 0 0 0
0 0 6 6 6 0 0 6 6 6 0
0 0 6 6 0 0 0 6 6 0 0
0 0 0 6 0 0 0 0 6 0 0
0 0 6 6 6 0 6 6 6 0 0
0 0 0 6 6 0 0 6 6 0 0
0 0 0 6 0 0 0 6 0 0 0
0 0 6 6 6 0 0 6 6 6 0
0 0 6 6 0 0 0 6 6 0 0
0 0 0 6 0 0 0 0 6 0 0
0 0 6 6 6 0 0 6 6 6 0
0 0 0 6 6 0 0 0 6 6 0
0 0 0 6 0 0 0 0 6 0 0
0 0 0 6 6 6 0 6 6 6 0
0 0 0 6 6 0 0 6 6 0 0
0 0 0 0 6 0 0 0 6 0 0
0 0 0 0 0 0 0 0 0 0 0
0 0 0 0 0 0 0 0 0 0 0
0 0 0 0 0 0 0 0 0 0 0
0 0 0 0 0 0 0 0 0 0 0
0 0 0 0 0 0 0 0 0 0 0
0 0 0 0 0 0 0 0 0 0 0
0 0 0 0 0 0 0 0 0 0 0
0 0 0 0 0 0 0 0 0 0 0
0 0 0 0 0 0 0 0 0 0 0
0 0 0 0 0 0 0 0 0 0 0
0 0 0 0 0 0 0 0 0 0 0
0 0 0 0 0 0 0 0 0 0 0
0 0 0 0 0 0 0 0 0 0 0
0 0 0 0 0 0 0 0 0 0 0
0 0 0 0 0 0 0 0 0 0 0
0 0 0 0 0 0 0 0 0 0 0
0 0 0 0 0 0 0 0 0 0 0
0 0 0 0 0 0 0 0 0 0 0
0 0 0 0 0 0 0 0 0 0 0
0 0 0 0 0 0 0 0 0 0 0
0 0 0 0 0 0 0 0 0 0 0
0 0 0 0 0 0 0 0 0 0 0
0 0 0 0 0 0 0 0 0 0 0
0 0 0 0 0 0 0 0 0 0 0
0 0 0 0 0 0 0 0 0 0 0
0 0 0 0 0 0 0 0 0 0 0
0 0 0 0 0 0 0 0 0 0 0
0 0 0 0 0 0 0 0 0 0 0
0 0 0 0 0 0 0 0 0 0 0
0 0 0 0 0 0 0 0 0 0 0
0 0 0 0 0 0 0 0 0 0 0
0 0 0 0 0 0 0 0 0 0 0
0 0 0 0 0 0 0 0 0 0 0
0 0 0 0 0 0 0 0 0 0 0
0 0 0 0 0 0 0 0 0 0 0
0 0 0 0 0 0 0 0 0 0 0
0 0 0 0 0 0 0 0 0 0 0
0 0 0 0 0 0 0 0 0 0 0
0 0 0 0 0 0 0 0 0 0 0
0 0 0 0 0 0 0 0 0 0 0
0 0 0 0 0 0 0 0 0 0 0