MODE 2
SIZE 11/70
LIMIT 0/18
COLOR LIMIT 4
STARS 500/1500/3000
POWERUPS 0/0/0/0
0 13 14 15 16 16 16 15 14 13 0
0 13 14 15 16 16 15 14 13 0 0
0 0 13 15 15 16 15 14 13 0 0
0 12 12 17 17 17 17 11 11 0 0
0 0 12 12 18 18 18 11 11 0 0
0 0 12 12 18 18 11 11 0 0 0
0 18 18 18 18 18 18 18 18 18 0
0 1 1 1 0 0 1 1 1 0 0
0 0 1 1 0 0 0 1 1 0 0
0 0 1 0 0 0 0 1 0 0 0
0 0 2 2 2 0 0 2 2 2 0
0 0 2 2 0 0 0 2 2 0 0
0 0 0 2 0 0 0 0 2 0 0
0 0 3 3 3 0 0 3 3 3 0
0 0 0 3 3 0 0 0 3 3 0
0 0 0 3 0 0 0 0 3 0 0
0 0 4 4 4 0 0 4 4 4 0
0 0 4 4 0 0 0 4 4 0 0
0 0 0 4 0 0 0 0 4 0 0
0 0 5 5 5 0 0 5 5 5 0
0 0 0 5 5 0 0 0 5 5 0
0 0 0 5 0 0 0 0 5 0 0
0 0 6 6 6 0 0 6 6 6 0
0 0 6 6 0 0 0 6 6 0 0
0 0 0 6 0 0 0 0 6 0 0
0 0 7 7 7 7 7 7 7 0 0
0 0 0 7 7 7 7 7 7 0 0
0 0 0 7 7 7 7 7 0 0 0
0 0 0 0 7 7 7 7 0 0 0
0 0 0 0 7 7 7 0 0 0 0
0 0 0 0 0 7 7 0 0 0 0
0 0 0 0 0 7 0 0 0 0 0
0 0 0 0 0 0 0 0 0 0 0
0 0 0 0 0 0 0 0 0 0 0
0 0 0 0 0 0 0 0 0 0 0
0 0 0 0 0 0 0 0 0 0 0
0 0 0 0 0 0 0 0 0 0 0
0 0 0 0 0 0 0 0 0 0 0
0 0 0 0 0 0 0 0 0 0 0
0 0 0 0 0 0 0 0 0 0 0
0 0 0 0 0 0 0 0 0 0 0
0 0 0 0 0 0 0 0 0 0 0
0 0 0 0 0 0 0 0 0 0 0
0 0 0 0 0 0 0 0 0 0 0
0 0 0 0 0 0 0 0 0 0 0
0 0 0 0 0 0 0 0 0 0 0
0 0 0 0 0 0 0 0 0 0 0
0 0 0 0 0 0 0 0 0 0 0
0 0 0 0 0 0 0 0 0 0 0
0 0 0 0 0 0 0 0 0 0 0
0 0 0 0 0 0 0 0 0 0 0
0 0 0 0 0 0 0 0 0 0 0
0 0 0 0 0 0 0 0 0 0 0
0 0 0 0 0 0 0 0 0 0 0
0 0 0 0 0 0 0 0 0 0 0
0 0 0 0 0 0 0 0 0 0 0
0 0 0 0 0 0 0 0 0 0 0
0 0 0 0 0 0 0 0 0 0 0
0 0 0 0 0 0 0 0 0 0 0
0 0 0 0 0 0 0 0 0 0 0
0 0 0 0 0 0 0 0 0 0 0
0 0 0 0 0 0 0 0 0 0 0
0 0 0 0 0 0 0 0 0 0 0
0 0 0 0 0 0 0 0 0 0 0
0 0 0 0 0 0 0 0 0 0 0
0 0 0 0 0 0 0 0 0 0 0
0 0 0 0 0 0 0 0 0 0 0
0 0 0 0 0 0 0 0 0 0 0
0 0 0 0 0 0 0 0 0 0 0
0 0 0 0 0 0 0 0 0 0 0