MODE 2
SIZE 11/70
LIMIT 0/28
COLOR LIMIT 4
STARS 500/1500/3000
POWERUPS 0/0/0/0
0 0 18 12 12 12 12 12 18 0 0
0 18 18 11 11 11 11 18 18 0 0
0 0 18 18 16 16 16 18 18 0 0
0 0 18 18 15 15 18 18 0 0 0
0 0 0 0 6 14 6 0 0 0 0
0 0 0 6 13 13 6 0 0 0 0
0 0 0 6 13 13 13 6 0 0 0
0 0 6 18 18 18 18 6 0 0 0
0 0 6 6 6 6 6 6 6 0 0
0 6 6 6 0 0 6 6 6 0 0
0 0 6 6 0 0 0 6 6 0 0
0 0 6 0 0 0 0 6 0 0 0
0 0 6 6 6 0 6 6 6 0 0
0 0 6 6 0 0 6 6 0 0 0
0 0 0 6 0 0 0 6 0 0 0
0 0 6 0 0 0 0 6 0 0 0
0 0 0 6 0 0 0 6 0 0 0
0 0 0 6 0 0 6 0 0 0 0
0 0 0 0 6 0 6 6 0 0 0
0 0 0 6 0 0 6 0 0 0 0
0 0 0 6 0 0 0 6 0 0 0
0 0 6 0 0 0 0 6 0 0 0
0 0 0 6 0 0 0 0 6 0 0
0 0 0 6 0 0 0 6 0 0 0
0 0 0 0 6 0 0 6 0 0 0
0 0 0 0 6 0 6 0 0 0 0
0 0 0 0 6 0 0 6 0 0 0
0 0 0 6 0 0 0 6 0 0 0
0 0 0 6 0 0 0 0 6 0 0
0 0 6 0 0 0 0 0 6 0 0
0 0 18 18 0 0 0 0 18 18 0
0 0 18 0 0 0 0 0 18 0 0
0 0 18 18 0 0 0 0 18 18 0
0 0 0 18 0 0 0 18 0 0 0
0 0 0 0 18 0 0 18 0 0 0
0 0 0 0 18 0 18 0 0 0 0
0 0 0 0 0 0 0 0 0 0 0
0 0 0 0 0 0 0 0 0 0 0
0 0 0 0 0 0 0 0 0 0 0
0 0 0 0 0 0 0 0 0 0 0
0 0 0 0 0 0 0 0 0 0 0
0 0 0 0 0 0 0 0 0 0 0
0 0 0 0 0 0 0 0 0 0 0
0 0 0 0 0 0 0 0 0 0 0
0 0 0 0 0 0 0 0 0 0 0
0 0 0 0 0 0 0 0 0 0 0
0 0 0 0 0 0 0 0 0 0 0
0 0 0 0 0 0 0 0 0 0 0
0 0 0 0 0 0 0 0 0 0 0
0 0 0 0 0 0 0 0 0 0 0
0 0 0 0 0 0 0 0 0 0 0
0 0 0 0 0 0 0 0 0 0 0
0 0 0 0 0 0 0 0 0 0 0
0 0 0 0 0 0 0 0 0 0 0
0 0 0 0 0 0 0 0 0 0 0
0 0 0 0 0 0 0 0 0 0 0
0 0 0 0 0 0 0 0 0 0 0
0 0 0 0 0 0 0 0 0 0 0
0 0 0 0 0 0 0 0 0 0 0
0 0 0 0 0 0 0 0 0 0 0
0 0 0 0 0 0 0 0 0 0 0
0 0 0 0 0 0 0 0 0 0 0
0 0 0 0 0 0 0 0 0 0 0
0 0 0 0 0 0 0 0 0 0 0
0 0 0 0 0 0 0 0 0 0 0
0 0 0 0 0 0 0 0 0 0 0
0 0 0 0 0 0 0 0 0 0 0
0 0 0 0 0 0 0 0 0 0 0
0 0 0 0 0 0 0 0 0 0 0
0 0 0 0 0 0 0 0 0 0 0