MODE 2
SIZE 11/70
LIMIT 0/32
COLOR LIMIT 4
STARS 500/1500/3000
POWERUPS 0/0/0/0
0 0 7 11 7 14 7 11 7 0 0
0 7 11 7 7 7 7 11 7 0 0
0 7 11 11 12 7 12 11 11 7 0
0 7 12 12 7 7 12 12 7 0 0
0 7 16 12 7 13 7 12 16 7 0
0 7 16 15 7 7 15 16 7 0 0
0 0 7 16 15 7 15 16 7 0 0
0 0 7 7 0 0 0 7 7 0 0
0 0 0 7 0 0 0 0 7 0 0
0 0 7 7 18 18 18 7 7 0 0
0 0 0 7 0 0 0 0 7 0 0
0 0 7 7 0 0 0 7 7 0 0
0 0 0 7 18 18 18 18 7 0 0
0 0 7 7 0 0 0 7 7 0 0
0 0 0 7 0 0 0 0 7 0 0
0 0 7 7 18 18 18 7 7 0 0
0 0 18 18 18 0 0 18 18 18 0
0 0 18 18 0 0 0 18 18 0 0
0 0 0 18 7 7 7 7 18 0 0
0 0 0 7 7 7 7 7 0 0 0
0 0 0 0 0 0 0 0 0 0 0
0 0 0 0 0 0 0 0 0 0 0
0 0 0 0 0 0 0 0 0 0 0
0 0 0 0 0 0 0 0 0 0 0
0 0 0 0 0 0 0 0 0 0 0
0 0 0 0 0 0 0 0 0 0 0
0 0 0 0 0 0 0 0 0 0 0
0 0 0 0 0 0 0 0 0 0 0
0 0 0 0 0 0 0 0 0 0 0
0 0 0 0 0 0 0 0 0 0 0
0 0 0 0 0 0 0 0 0 0 0
0 0 0 0 0 0 0 0 0 0 0
0 0 0 0 0 0 0 0 0 0 0
0 0 0 0 0 0 0 0 0 0 0
0 0 0 0 0 0 0 0 0 0 0
0 0 0 0 0 0 0 0 0 0 0
0 0 0 0 0 0 0 0 0 0 0
0 0 0 0 0 0 0 0 0 0 0
0 0 0 0 0 0 0 0 0 0 0
0 0 0 0 0 0 0 0 0 0 0
0 0 0 0 0 0 0 0 0 0 0
0 0 0 0 0 0 0 0 0 0 0
0 0 0 0 0 0 0 0 0 0 0
0 0 0 0 0 0 0 0 0 0 0
0 0 0 0 0 0 0 0 0 0 0
0 0 0 0 0 0 0 0 0 0 0
0 0 0 0 0 0 0 0 0 0 0
0 0 0 0 0 0 0 0 0 0 0
0 0 0 0 0 0 0 0 0 0 0
0 0 0 0 0 0 0 0 0 0 0
0 0 0 0 0 0 0 0 0 0 0
0 0 0 0 0 0 0 0 0 0 0
0 0 0 0 0 0 0 0 0 0 0
0 0 0 0 0 0 0 0 0 0 0
0 0 0 0 0 0 0 0 0 0 0
0 0 0 0 0 0 0 0 0 0 0
0 0 0 0 0 0 0 0 0 0 0
0 0 0 0 0 0 0 0 0 0 0
0 0 0 0 0 0 0 0 0 0 0
0 0 0 0 0 0 0 0 0 0 0
0 0 0 0 0 0 0 0 0 0 0
0 0 0 0 0 0 0 0 0 0 0
0 0 0 0 0 0 0 0 0 0 0
0 0 0 0 0 0 0 0 0 0 0
0 0 0 0 0 0 0 0 0 0 0
0 0 0 0 0 0 0 0 0 0 0
0 0 0 0 0 0 0 0 0 0 0
0 0 0 0 0 0 0 0 0 0 0
0 0 0 0 0 0 0 0 0 0 0
0 0 0 0 0 0 0 0 0 0 0