MODE 2
SIZE 11/70
LIMIT 0/25
COLOR LIMIT 4
STARS 500/1500/3000
POWERUPS 0/0/0/0
0 0 0 18 12 12 12 12 18 0 0
0 0 17 18 16 16 16 18 17 0 0
0 0 0 17 18 15 15 18 17 0 0
0 0 17 18 18 14 18 18 17 0 0
0 0 0 18 13 13 13 13 18 0 0
0 0 0 18 11 11 11 18 0 0 0
0 0 0 18 0 0 0 0 18 0 0
0 0 6 18 0 0 0 18 6 0 0
0 0 0 6 18 0 0 18 6 0 0
0 0 7 7 7 0 7 7 7 0 0
0 0 0 7 7 0 0 7 7 0 0
0 0 0 7 0 0 0 7 0 0 0
0 0 0 7 7 0 0 7 7 0 0
0 0 0 6 0 0 0 6 0 0 0
0 0 0 6 6 0 0 6 6 0 0
0 0 0 6 0 0 0 6 0 0 0
0 0 0 6 6 0 0 6 6 0 0
0 0 0 6 0 0 0 6 0 0 0
0 0 6 6 6 0 0 6 6 6 0
0 0 6 6 0 0 0 6 6 0 0
0 0 0 6 0 0 0 0 6 0 0
0 0 6 6 0 0 0 6 6 0 0
0 0 0 6 0 0 0 0 6 0 0
0 0 6 6 0 0 0 6 6 0 0
0 0 0 6 0 0 0 0 6 0 0
0 0 0 0 0 0 0 0 0 0 0
0 0 0 0 0 0 0 0 0 0 0
0 0 0 0 0 0 0 0 0 0 0
0 0 0 0 0 0 0 0 0 0 0
0 0 0 0 0 0 0 0 0 0 0
0 0 0 0 0 0 0 0 0 0 0
0 0 0 0 0 0 0 0 0 0 0
0 0 0 0 0 0 0 0 0 0 0
0 0 0 0 0 0 0 0 0 0 0
0 0 0 0 0 0 0 0 0 0 0
0 0 0 0 0 0 0 0 0 0 0
0 0 0 0 0 0 0 0 0 0 0
0 0 0 0 0 0 0 0 0 0 0
0 0 0 0 0 0 0 0 0 0 0
0 0 0 0 0 0 0 0 0 0 0
0 0 0 0 0 0 0 0 0 0 0
0 0 0 0 0 0 0 0 0 0 0
0 0 0 0 0 0 0 0 0 0 0
0 0 0 0 0 0 0 0 0 0 0
0 0 0 0 0 0 0 0 0 0 0
0 0 0 0 0 0 0 0 0 0 0
0 0 0 0 0 0 0 0 0 0 0
0 0 0 0 0 0 0 0 0 0 0
0 0 0 0 0 0 0 0 0 0 0
0 0 0 0 0 0 0 0 0 0 0
0 0 0 0 0 0 0 0 0 0 0
0 0 0 0 0 0 0 0 0 0 0
0 0 0 0 0 0 0 0 0 0 0
0 0 0 0 0 0 0 0 0 0 0
0 0 0 0 0 0 0 0 0 0 0
0 0 0 0 0 0 0 0 0 0 0
0 0 0 0 0 0 0 0 0 0 0
0 0 0 0 0 0 0 0 0 0 0
0 0 0 0 0 0 0 0 0 0 0
0 0 0 0 0 0 0 0 0 0 0
0 0 0 0 0 0 0 0 0 0 0
0 0 0 0 0 0 0 0 0 0 0
0 0 0 0 0 0 0 0 0 0 0
0 0 0 0 0 0 0 0 0 0 0
0 0 0 0 0 0 0 0 0 0 0
0 0 0 0 0 0 0 0 0 0 0
0 0 0 0 0 0 0 0 0 0 0
0 0 0 0 0 0 0 0 0 0 0
0 0 0 0 0 0 0 0 0 0 0
0 0 0 0 0 0 0 0 0 0 0