MODE 2
SIZE 11/70
LIMIT 0/30
COLOR LIMIT 4
STARS 500/1500/3000
POWERUPS 0/0/0/0
0 7 12 12 11 7 11 12 12 7 0
0 7 12 11 7 7 11 12 7 0 0
0 7 16 11 7 7 7 11 16 7 0
7 18 16 14 7 7 14 16 18 7 0
0 18 13 16 14 7 14 16 13 18 0
0 18 13 7 7 7 7 13 18 0 0
0 0 18 7 7 7 7 7 18 0 0
0 0 6 6 6 6 6 6 6 0 0
0 0 0 6 6 6 6 6 6 0 0
0 0 7 7 0 0 0 7 7 0 0
0 0 0 7 7 0 0 7 7 0 0
0 0 7 7 7 0 7 7 7 0 0
0 0 7 7 7 7 7 7 7 7 0
0 0 7 7 7 0 7 7 7 0 0
0 0 0 7 7 0 0 7 7 0 0
0 0 0 7 0 0 0 7 0 0 0
0 0 7 7 7 0 0 7 7 7 0
0 0 7 7 0 0 0 7 7 0 0
0 0 0 7 0 0 0 0 7 0 0
0 6 6 6 6 0 6 6 6 6 0
0 0 6 6 6 0 0 6 6 6 0
0 5 6 6 5 0 5 6 6 5 0
0 0 5 5 5 0 0 5 5 5 0
0 1 1 1 1 0 1 1 1 1 0
0 0 2 2 2 0 0 2 2 2 0
0 0 2 2 0 0 0 2 2 0 0
0 0 0 2 0 0 0 0 2 0 0
0 0 0 0 0 0 0 0 0 0 0
0 0 0 0 0 0 0 0 0 0 0
0 0 0 0 0 0 0 0 0 0 0
0 0 0 0 0 0 0 0 0 0 0
0 0 0 0 0 0 0 0 0 0 0
0 0 0 0 0 0 0 0 0 0 0
0 0 0 0 0 0 0 0 0 0 0
0 0 0 0 0 0 0 0 0 0 0
0 0 0 0 0 0 0 0 0 0 0
0 0 0 0 0 0 0 0 0 0 0
0 0 0 0 0 0 0 0 0 0 0
0 0 0 0 0 0 0 0 0 0 0
0 0 0 0 0 0 0 0 0 0 0
0 0 0 0 0 0 0 0 0 0 0
0 0 0 0 0 0 0 0 0 0 0
0 0 0 0 0 0 0 0 0 0 0
0 0 0 0 0 0 0 0 0 0 0
0 0 0 0 0 0 0 0 0 0 0
0 0 0 0 0 0 0 0 0 0 0
0 0 0 0 0 0 0 0 0 0 0
0 0 0 0 0 0 0 0 0 0 0
0 0 0 0 0 0 0 0 0 0 0
0 0 0 0 0 0 0 0 0 0 0
0 0 0 0 0 0 0 0 0 0 0
0 0 0 0 0 0 0 0 0 0 0
0 0 0 0 0 0 0 0 0 0 0
0 0 0 0 0 0 0 0 0 0 0
0 0 0 0 0 0 0 0 0 0 0
0 0 0 0 0 0 0 0 0 0 0
0 0 0 0 0 0 0 0 0 0 0
0 0 0 0 0 0 0 0 0 0 0
0 0 0 0 0 0 0 0 0 0 0
0 0 0 0 0 0 0 0 0 0 0
0 0 0 0 0 0 0 0 0 0 0
0 0 0 0 0 0 0 0 0 0 0
0 0 0 0 0 0 0 0 0 0 0
0 0 0 0 0 0 0 0 0 0 0
0 0 0 0 0 0 0 0 0 0 0
0 0 0 0 0 0 0 0 0 0 0
0 0 0 0 0 0 0 0 0 0 0
0 0 0 0 0 0 0 0 0 0 0
0 0 0 0 0 0 0 0 0 0 0
0 0 0 0 0 0 0 0 0 0 0