MODE 2
SIZE 11/70
LIMIT 0/25
COLOR LIMIT 4
STARS 500/1500/3000
POWERUPS 0/0/0/0
0 17 13 14 18 11 18 14 13 17 0
0 17 13 14 18 18 14 13 17 0 0
0 12 12 13 14 11 14 13 12 12 0
17 12 15 16 1 1 16 15 12 17 0
0 17 15 16 1 11 1 16 15 17 0
0 15 16 1 1 1 1 16 15 0 0
0 1 1 1 1 11 1 1 1 1 0
0 2 2 2 0 0 2 2 2 0 0
0 0 2 2 0 0 0 2 2 0 0
0 0 2 5 5 5 5 2 0 0 0
0 0 7 7 5 5 5 7 7 0 0
0 0 7 0 5 5 0 7 0 0 0
0 0 7 7 0 5 0 7 7 0 0
0 0 7 0 7 7 0 7 0 0 0
0 0 7 7 0 7 0 7 7 0 0
0 0 7 0 7 7 0 7 0 0 0
0 0 7 7 0 7 0 7 7 0 0
0 0 7 0 7 7 0 7 0 0 0
0 0 6 6 0 6 0 6 6 0 0
0 0 6 0 6 6 0 6 0 0 0
0 0 6 6 0 6 0 6 6 0 0
0 0 6 0 6 6 0 6 0 0 0
0 0 6 6 0 6 0 6 6 0 0
0 0 0 0 0 0 0 0 0 0 0
0 0 0 0 0 0 0 0 0 0 0
0 0 0 0 0 0 0 0 0 0 0
0 0 0 0 0 0 0 0 0 0 0
0 0 0 0 0 0 0 0 0 0 0
0 0 0 0 0 0 0 0 0 0 0
0 0 0 0 0 0 0 0 0 0 0
0 0 0 0 0 0 0 0 0 0 0
0 0 0 0 0 0 0 0 0 0 0
0 0 0 0 0 0 0 0 0 0 0
0 0 0 0 0 0 0 0 0 0 0
0 0 0 0 0 0 0 0 0 0 0
0 0 0 0 0 0 0 0 0 0 0
0 0 0 0 0 0 0 0 0 0 0
0 0 0 0 0 0 0 0 0 0 0
0 0 0 0 0 0 0 0 0 0 0
0 0 0 0 0 0 0 0 0 0 0
0 0 0 0 0 0 0 0 0 0 0
0 0 0 0 0 0 0 0 0 0 0
0 0 0 0 0 0 0 0 0 0 0
0 0 0 0 0 0 0 0 0 0 0
0 0 0 0 0 0 0 0 0 0 0
0 0 0 0 0 0 0 0 0 0 0
0 0 0 0 0 0 0 0 0 0 0
0 0 0 0 0 0 0 0 0 0 0
0 0 0 0 0 0 0 0 0 0 0
0 0 0 0 0 0 0 0 0 0 0
0 0 0 0 0 0 0 0 0 0 0
0 0 0 0 0 0 0 0 0 0 0
0 0 0 0 0 0 0 0 0 0 0
0 0 0 0 0 0 0 0 0 0 0
0 0 0 0 0 0 0 0 0 0 0
0 0 0 0 0 0 0 0 0 0 0
0 0 0 0 0 0 0 0 0 0 0
0 0 0 0 0 0 0 0 0 0 0
0 0 0 0 0 0 0 0 0 0 0
0 0 0 0 0 0 0 0 0 0 0
0 0 0 0 0 0 0 0 0 0 0
0 0 0 0 0 0 0 0 0 0 0
0 0 0 0 0 0 0 0 0 0 0
0 0 0 0 0 0 0 0 0 0 0
0 0 0 0 0 0 0 0 0 0 0
0 0 0 0 0 0 0 0 0 0 0
0 0 0 0 0 0 0 0 0 0 0
0 0 0 0 0 0 0 0 0 0 0
0 0 0 0 0 0 0 0 0 0 0
0 0 0 0 0 0 0 0 0 0 0