MODE 2
SIZE 11/70
LIMIT 0/10
COLOR LIMIT 4
STARS 500/1500/3000
POWERUPS 0/0/0/0
0 0 16 16 16 16 16 16 16 0 0
0 0 18 18 15 15 15 18 18 0 0
0 0 9 18 18 15 15 18 18 9 0
0 0 0 18 18 18 18 18 0 0 0
0 0 0 8 18 18 18 18 8 0 0
0 0 6 10 0 6 6 0 14 6 0
0 0 6 6 0 6 6 0 6 6 0
0 6 6 0 6 6 0 6 6 0 0
0 0 6 6 0 6 6 0 6 6 0
0 0 6 6 0 6 6 0 6 6 0
0 0 0 6 6 0 6 6 0 6 6
0 0 6 6 0 6 6 0 6 6 0
0 0 6 6 0 6 6 0 6 6 0
0 6 6 0 6 6 0 6 6 0 0
0 6 6 6 0 6 0 6 6 6 0
0 6 6 0 6 6 0 6 6 0 0
0 0 6 0 6 6 6 0 6 0 0
0 6 6 0 6 6 0 6 6 0 0
0 0 6 0 0 6 0 0 6 0 0
0 6 6 0 6 6 0 6 6 0 0
0 0 6 0 0 6 0 0 6 0 0
0 6 6 0 6 6 0 6 6 0 0
0 0 6 0 0 6 0 0 6 0 0
0 6 6 0 6 6 0 6 6 0 0
0 0 6 0 0 0 0 0 6 0 0
0 0 6 0 0 0 0 6 0 0 0
0 0 0 6 0 0 0 6 0 0 0
0 0 0 6 0 0 6 0 0 0 0
0 0 0 0 6 0 6 0 0 0 0
0 0 0 6 0 0 6 0 0 0 0
0 0 0 6 0 0 0 6 0 0 0
0 0 6 0 0 0 0 6 0 0 0
0 0 0 0 0 0 0 0 0 0 0
0 0 0 0 0 0 0 0 0 0 0
0 0 0 0 0 0 0 0 0 0 0
0 0 0 0 0 0 0 0 0 0 0
0 0 0 0 0 0 0 0 0 0 0
0 0 0 0 0 0 0 0 0 0 0
0 0 0 0 0 0 0 0 0 0 0
0 0 0 0 0 0 0 0 0 0 0
0 0 0 0 0 0 0 0 0 0 0
0 0 0 0 0 0 0 0 0 0 0
0 0 0 0 0 0 0 0 0 0 0
0 0 0 0 0 0 0 0 0 0 0
0 0 0 0 0 0 0 0 0 0 0
0 0 0 0 0 0 0 0 0 0 0
0 0 0 0 0 0 0 0 0 0 0
0 0 0 0 0 0 0 0 0 0 0
0 0 0 0 0 0 0 0 0 0 0
0 0 0 0 0 0 0 0 0 0 0
0 0 0 0 0 0 0 0 0 0 0
0 0 0 0 0 0 0 0 0 0 0
0 0 0 0 0 0 0 0 0 0 0
0 0 0 0 0 0 0 0 0 0 0
0 0 0 0 0 0 0 0 0 0 0
0 0 0 0 0 0 0 0 0 0 0
0 0 0 0 0 0 0 0 0 0 0
0 0 0 0 0 0 0 0 0 0 0
0 0 0 0 0 0 0 0 0 0 0
0 0 0 0 0 0 0 0 0 0 0
0 0 0 0 0 0 0 0 0 0 0
0 0 0 0 0 0 0 0 0 0 0
0 0 0 0 0 0 0 0 0 0 0
0 0 0 0 0 0 0 0 0 0 0
0 0 0 0 0 0 0 0 0 0 0
0 0 0 0 0 0 0 0 0 0 0
0 0 0 0 0 0 0 0 0 0 0
0 0 0 0 0 0 0 0 0 0 0
0 0 0 0 0 0 0 0 0 0 0
0 0 0 0 0 0 0 0 0 0 0