MODE 2
SIZE 11/70
LIMIT 0/20
COLOR LIMIT 4
STARS 500/1500/4600
POWERUPS 0/0/0/0
0 18 11 12 14 14 14 12 11 18 0
0 18 11 12 14 14 12 11 18 0 0
0 0 16 11 12 14 12 11 16 0 0
0 15 16 18 18 18 18 16 15 0 0
0 0 15 16 18 18 18 16 15 0 0
0 6 15 18 18 18 18 15 6 0 0
0 0 6 15 18 18 18 15 6 0 0
0 0 6 18 6 6 18 6 0 0 0
0 0 6 18 6 6 6 18 6 0 0
0 6 6 6 6 6 6 6 6 0 0
0 0 6 6 6 0 6 6 6 0 0
0 0 6 6 0 0 6 6 0 0 0
0 0 0 6 6 6 6 6 0 0 0
0 0 0 0 6 6 0 0 0 0 0
0 0 0 0 6 6 6 0 0 0 0
0 0 0 6 6 6 6 0 0 0 0
0 0 0 6 6 6 6 6 0 0 0
0 0 6 6 6 6 6 6 0 0 0
0 0 6 0 6 0 6 0 6 0 0
0 6 0 6 0 6 0 6 0 0 0
0 6 0 6 0 6 0 6 0 0 0
0 6 0 6 0 6 0 6 0 0 0
0 0 6 0 6 0 6 0 6 0 0
0 0 6 0 6 0 6 0 6 0 0
0 0 0 0 0 0 0 0 0 6 0
0 0 0 0 0 0 0 0 6 0 0
0 0 0 0 0 0 0 0 6 0 0
0 6 6 6 6 6 6 6 0 0 0
0 0 0 0 0 0 0 0 6 0 0
0 0 0 0 0 0 0 6 0 0 0
0 0 0 0 0 0 0 6 0 0 0
0 6 6 6 6 6 6 0 0 0 0
0 0 0 0 0 0 0 0 0 0 0
0 0 0 0 0 0 0 0 0 0 0
0 0 0 0 0 0 0 0 0 0 0
0 0 0 0 0 0 0 0 0 0 0
0 0 0 0 0 0 0 0 0 0 0
0 0 0 0 0 0 0 0 0 0 0
0 0 0 0 0 0 0 0 0 0 0
0 0 0 0 0 0 0 0 0 0 0
0 0 0 0 0 0 0 0 0 0 0
0 0 0 0 0 0 0 0 0 0 0
0 0 0 0 0 0 0 0 0 0 0
0 0 0 0 0 0 0 0 0 0 0
0 0 0 0 0 0 0 0 0 0 0
0 0 0 0 0 0 0 0 0 0 0
0 0 0 0 0 0 0 0 0 0 0
0 0 0 0 0 0 0 0 0 0 0
0 0 0 0 0 0 0 0 0 0 0
0 0 0 0 0 0 0 0 0 0 0
0 0 0 0 0 0 0 0 0 0 0
0 0 0 0 0 0 0 0 0 0 0
0 0 0 0 0 0 0 0 0 0 0
0 0 0 0 0 0 0 0 0 0 0
0 0 0 0 0 0 0 0 0 0 0
0 0 0 0 0 0 0 0 0 0 0
0 0 0 0 0 0 0 0 0 0 0
0 0 0 0 0 0 0 0 0 0 0
0 0 0 0 0 0 0 0 0 0 0
0 0 0 0 0 0 0 0 0 0 0
0 0 0 0 0 0 0 0 0 0 0
0 0 0 0 0 0 0 0 0 0 0
0 0 0 0 0 0 0 0 0 0 0
0 0 0 0 0 0 0 0 0 0 0
0 0 0 0 0 0 0 0 0 0 0
0 0 0 0 0 0 0 0 0 0 0
0 0 0 0 0 0 0 0 0 0 0
0 0 0 0 0 0 0 0 0 0 0
0 0 0 0 0 0 0 0 0 0 0
0 0 0 0 0 0 0 0 0 0 0