MODE 2
SIZE 11/70
LIMIT 0/22
COLOR LIMIT 4
STARS 1000/2000/3000
POWERUPS 0/0/0/0
0 0 16 16 15 14 15 16 16 0 0
0 16 16 15 14 14 15 16 16 0 0
0 16 16 15 14 0 14 15 16 16 0
0 6 16 16 16 16 16 16 6 0 0
0 0 6 6 6 0 0 6 6 6 0
0 6 6 6 0 0 0 6 6 6 0
0 0 6 6 0 0 0 0 6 6 0
0 6 6 6 0 0 0 6 6 6 0
0 0 6 6 6 0 0 6 6 6 0
0 0 6 6 6 0 6 6 6 0 0
0 0 0 6 6 0 0 6 6 0 0
0 0 6 6 6 0 6 6 6 0 0
0 0 6 6 6 0 0 6 6 6 0
0 6 6 6 0 0 0 6 6 6 0
0 0 0 6 0 0 0 0 6 0 0
0 0 6 6 0 0 0 6 6 0 0
0 0 0 6 0 0 0 0 6 0 0
0 0 6 6 0 0 0 6 6 0 0
0 0 0 6 0 0 0 0 6 0 0
0 0 6 6 0 0 0 6 6 0 0
0 0 0 6 0 0 0 0 6 0 0
0 0 6 6 0 0 0 6 6 0 0
0 0 0 0 0 0 0 0 6 0 0
0 0 0 0 0 0 0 0 0 0 0
0 0 0 0 0 0 0 0 0 0 0
0 0 0 0 0 0 0 0 0 0 0
0 0 0 0 0 0 0 0 0 0 0
0 0 0 0 0 0 0 0 0 0 0
0 0 0 0 0 0 0 0 0 0 0
0 0 0 0 0 0 0 0 0 0 0
0 0 0 0 0 0 0 0 0 0 0
0 0 0 0 0 0 0 0 0 0 0
0 0 0 0 0 0 0 0 0 0 0
0 0 0 0 0 0 0 0 0 0 0
0 0 0 0 0 0 0 0 0 0 0
0 0 0 0 0 0 0 0 0 0 0
0 0 0 0 0 0 0 0 0 0 0
0 0 0 0 0 0 0 0 0 0 0
0 0 0 0 0 0 0 0 0 0 0
0 0 0 0 0 0 0 0 0 0 0
0 0 0 0 0 0 0 0 0 0 0
0 0 0 0 0 0 0 0 0 0 0
0 0 0 0 0 0 0 0 0 0 0
0 0 0 0 0 0 0 0 0 0 0
0 0 0 0 0 0 0 0 0 0 0
0 0 0 0 0 0 0 0 0 0 0
0 0 0 0 0 0 0 0 0 0 0
0 0 0 0 0 0 0 0 0 0 0
0 0 0 0 0 0 0 0 0 0 0
0 0 0 0 0 0 0 0 0 0 0
0 0 0 0 0 0 0 0 0 0 0
0 0 0 0 0 0 0 0 0 0 0
0 0 0 0 0 0 0 0 0 0 0
0 0 0 0 0 0 0 0 0 0 0
0 0 0 0 0 0 0 0 0 0 0
0 0 0 0 0 0 0 0 0 0 0
0 0 0 0 0 0 0 0 0 0 0
0 0 0 0 0 0 0 0 0 0 0
0 0 0 0 0 0 0 0 0 0 0
0 0 0 0 0 0 0 0 0 0 0
0 0 0 0 0 0 0 0 0 0 0
0 0 0 0 0 0 0 0 0 0 0
0 0 0 0 0 0 0 0 0 0 0
0 0 0 0 0 0 0 0 0 0 0
0 0 0 0 0 0 0 0 0 0 0
0 0 0 0 0 0 0 0 0 0 0
0 0 0 0 0 0 0 0 0 0 0
0 0 0 0 0 0 0 0 0 0 0
0 0 0 0 0 0 0 0 0 0 0
0 0 0 0 0 0 0 0 0 0 0