MODE 2
SIZE 11/70
LIMIT 0/25
COLOR LIMIT 4
STARS 200/900/2000
POWERUPS 1/1/1/1
0 16 14 12 14 15 14 12 14 16 0
0 16 14 14 11 11 14 14 16 0 0
0 16 16 14 15 0 15 14 16 16 0
0 16 16 16 16 16 16 16 16 0 0
0 6 9 6 18 18 18 6 9 6 0
0 6 6 2 18 18 2 6 6 0 0
0 0 6 2 2 18 2 2 6 0 0
0 0 2 2 2 2 2 2 0 0 0
0 0 3 0 0 0 0 3 0 0 0
0 3 3 0 0 0 3 3 0 0 0
0 3 3 3 0 0 3 3 3 0 0
0 0 4 0 0 0 4 0 0 0 0
0 0 4 4 0 0 4 4 0 0 0
0 4 4 4 0 4 4 4 0 0 0
0 0 0 5 0 0 5 0 0 0 0
0 0 5 5 0 5 5 0 0 0 0
0 0 5 5 5 5 5 5 0 0 0
0 0 0 0 6 0 0 0 0 0 0
0 0 0 0 6 6 0 0 0 0 0
0 0 0 6 6 6 0 0 0 0 0
0 0 0 6 0 0 6 0 0 0 0
0 0 6 0 0 0 6 0 0 0 0
0 0 6 0 0 0 0 6 0 0 0
0 6 6 0 0 0 6 6 0 0 0
0 0 6 6 0 0 0 6 0 0 0
0 0 6 0 0 0 6 0 0 0 0
0 0 0 6 0 0 6 0 0 0 0
0 0 6 6 0 6 6 0 0 0 0
0 0 6 6 6 6 6 6 0 0 0
0 6 6 6 6 6 6 6 0 0 0
0 0 0 0 0 0 0 0 0 0 0
0 0 0 0 0 0 0 0 0 0 0
0 0 0 0 0 0 0 0 0 0 0
0 0 0 0 0 0 0 0 0 0 0
0 0 0 0 0 0 0 0 0 0 0
0 0 0 0 0 0 0 0 0 0 0
0 0 0 0 0 0 0 0 0 0 0
0 0 0 0 0 0 0 0 0 0 0
0 0 0 0 0 0 0 0 0 0 0
0 0 0 0 0 0 0 0 0 0 0
0 0 0 0 0 0 0 0 0 0 0
0 0 0 0 0 0 0 0 0 0 0
0 0 0 0 0 0 0 0 0 0 0
0 0 0 0 0 0 0 0 0 0 0
0 0 0 0 0 0 0 0 0 0 0
0 0 0 0 0 0 0 0 0 0 0
0 0 0 0 0 0 0 0 0 0 0
0 0 0 0 0 0 0 0 0 0 0
0 0 0 0 0 0 0 0 0 0 0
0 0 0 0 0 0 0 0 0 0 0
0 0 0 0 0 0 0 0 0 0 0
0 0 0 0 0 0 0 0 0 0 0
0 0 0 0 0 0 0 0 0 0 0
0 0 0 0 0 0 0 0 0 0 0
0 0 0 0 0 0 0 0 0 0 0
0 0 0 0 0 0 0 0 0 0 0
0 0 0 0 0 0 0 0 0 0 0
0 0 0 0 0 0 0 0 0 0 0
0 0 0 0 0 0 0 0 0 0 0
0 0 0 0 0 0 0 0 0 0 0
0 0 0 0 0 0 0 0 0 0 0
0 0 0 0 0 0 0 0 0 0 0
0 0 0 0 0 0 0 0 0 0 0
0 0 0 0 0 0 0 0 0 0 0
0 0 0 0 0 0 0 0 0 0 0
0 0 0 0 0 0 0 0 0 0 0
0 0 0 0 0 0 0 0 0 0 0
0 0 0 0 0 0 0 0 0 0 0
0 0 0 0 0 0 0 0 0 0 0
0 0 0 0 0 0 0 0 0 0 0