MODE 2
SIZE 11/70
LIMIT 0/36
COLOR LIMIT 4
STARS 500/1400/2600
POWERUPS 0/0/0/0
0 0 6 12 6 0 0 6 6 13 6
0 6 0 0 6 0 6 0 0 6 0
0 6 0 0 6 0 6 0 0 6 0
18 0 0 18 17 18 0 0 18 0 0
0 6 0 0 6 0 6 0 0 6 0
0 6 0 0 6 0 6 0 0 6 0
0 0 6 6 6 0 0 6 6 6 6
0 17 6 6 17 14 17 6 6 17 0
0 0 6 6 6 0 0 6 0 0 6
0 6 0 0 6 0 6 0 0 6 0
0 6 0 0 6 0 6 0 0 6 0
18 0 0 15 17 15 0 0 18 0 0
0 6 0 0 6 0 6 0 0 6 0
0 6 0 0 6 6 6 0 0 6 0
0 0 2 6 6 0 0 6 6 2 0
0 0 0 2 0 0 2 0 0 0 0
0 0 0 0 2 0 0 2 0 0 0
0 0 0 0 16 0 0 16 0 0 0
0 0 0 0 6 0 0 6 0 0 0
0 0 0 6 0 0 6 0 0 0 0
0 0 0 0 17 6 6 17 0 0 0
0 0 0 0 0 0 0 0 0 0 0
0 0 0 0 0 0 0 0 0 0 0
0 0 0 0 0 0 0 0 0 0 0
0 0 0 0 0 0 0 0 0 0 0
0 0 0 0 0 0 0 0 0 0 0
0 0 0 0 0 0 0 0 0 0 0
0 0 0 0 0 0 0 0 0 0 0
0 0 0 0 0 0 0 0 0 0 0
0 0 0 0 0 0 0 0 0 0 0
0 0 0 0 0 0 0 0 0 0 0
0 0 0 0 0 0 0 0 0 0 0
0 0 0 0 0 0 0 0 0 0 0
0 0 0 0 0 0 0 0 0 0 0
0 0 0 0 0 0 0 0 0 0 0
0 0 0 0 0 0 0 0 0 0 0
0 0 0 0 0 0 0 0 0 0 0
0 0 0 0 0 0 0 0 0 0 0
0 0 0 0 0 0 0 0 0 0 0
0 0 0 0 0 0 0 0 0 0 0
0 0 0 0 0 0 0 0 0 0 0
0 0 0 0 0 0 0 0 0 0 0
0 0 0 0 0 0 0 0 0 0 0
0 0 0 0 0 0 0 0 0 0 0
0 0 0 0 0 0 0 0 0 0 0
0 0 0 0 0 0 0 0 0 0 0
0 0 0 0 0 0 0 0 0 0 0
0 0 0 0 0 0 0 0 0 0 0
0 0 0 0 0 0 0 0 0 0 0
0 0 0 0 0 0 0 0 0 0 0
0 0 0 0 0 0 0 0 0 0 0
0 0 0 0 0 0 0 0 0 0 0
0 0 0 0 0 0 0 0 0 0 0
0 0 0 0 0 0 0 0 0 0 0
0 0 0 0 0 0 0 0 0 0 0
0 0 0 0 0 0 0 0 0 0 0
0 0 0 0 0 0 0 0 0 0 0
0 0 0 0 0 0 0 0 0 0 0
0 0 0 0 0 0 0 0 0 0 0
0 0 0 0 0 0 0 0 0 0 0
0 0 0 0 0 0 0 0 0 0 0
0 0 0 0 0 0 0 0 0 0 0
0 0 0 0 0 0 0 0 0 0 0
0 0 0 0 0 0 0 0 0 0 0
0 0 0 0 0 0 0 0 0 0 0
0 0 0 0 0 0 0 0 0 0 0
0 0 0 0 0 0 0 0 0 0 0
0 0 0 0 0 0 0 0 0 0 0
0 0 0 0 0 0 0 0 0 0 0
0 0 0 0 0 0 0 0 0 0 0