MODE 2
SIZE 11/70
LIMIT 0/45
COLOR LIMIT 4
STARS 1000/2000/3000
POWERUPS 0/0/0/0
0 18 15 10 15 18 0 0 0 0 0
0 18 8 8 18 18 0 0 0 0 0
0 18 15 16 15 16 18 0 0 0 0
0 18 18 0 14 18 14 0 0 0 0
0 0 18 16 0 16 18 17 17 0 0
0 6 18 18 14 13 14 13 17 0 0
0 6 6 6 18 9 9 9 17 17 0
0 6 6 18 18 13 11 13 11 17 0
0 0 6 6 6 18 0 0 0 17 0
0 0 6 6 18 18 11 12 11 12 0
0 0 0 6 6 6 18 8 8 8 0
0 0 6 6 6 18 18 12 6 12 0
0 0 0 6 6 6 6 18 6 6 0
0 0 0 6 6 6 18 6 6 6 0
0 0 0 0 6 0 0 6 0 0 0
0 0 0 0 6 0 6 0 0 0 0
0 0 0 0 0 6 6 0 0 0 0
0 0 0 0 6 6 6 0 0 0 0
0 0 0 0 6 6 6 6 0 0 0
0 0 0 6 0 0 0 6 0 0 0
0 0 0 6 0 0 0 0 6 0 0
0 0 6 0 0 0 0 0 6 0 0
0 0 6 0 0 0 0 0 0 6 0
0 0 6 6 6 6 6 6 6 0 0
0 0 0 6 6 6 6 6 6 0 0
0 0 0 6 0 0 0 6 0 0 0
0 0 0 0 6 0 0 6 0 0 0
0 0 0 0 6 0 6 0 0 0 0
0 0 0 0 6 0 0 6 0 0 0
0 0 0 6 0 0 0 6 0 0 0
0 0 0 6 6 0 0 6 6 0 0
0 0 0 6 6 0 6 6 0 0 0
0 0 0 6 6 0 0 6 6 0 0
0 0 0 6 0 0 0 6 0 0 0
0 0 0 0 6 0 0 6 0 0 0
0 0 0 0 6 0 6 0 0 0 0
0 0 0 0 0 6 6 0 0 0 0
0 0 0 0 0 6 0 0 0 0 0
0 0 0 0 0 0 0 0 0 0 0
0 0 0 0 0 0 0 0 0 0 0
0 0 0 0 0 0 0 0 0 0 0
0 0 0 0 0 0 0 0 0 0 0
0 0 0 0 0 0 0 0 0 0 0
0 0 0 0 0 0 0 0 0 0 0
0 0 0 0 0 0 0 0 0 0 0
0 0 0 0 0 0 0 0 0 0 0
0 0 0 0 0 0 0 0 0 0 0
0 0 0 0 0 0 0 0 0 0 0
0 0 0 0 0 0 0 0 0 0 0
0 0 0 0 0 0 0 0 0 0 0
0 0 0 0 0 0 0 0 0 0 0
0 0 0 0 0 0 0 0 0 0 0
0 0 0 0 0 0 0 0 0 0 0
0 0 0 0 0 0 0 0 0 0 0
0 0 0 0 0 0 0 0 0 0 0
0 0 0 0 0 0 0 0 0 0 0
0 0 0 0 0 0 0 0 0 0 0
0 0 0 0 0 0 0 0 0 0 0
0 0 0 0 0 0 0 0 0 0 0
0 0 0 0 0 0 0 0 0 0 0
0 0 0 0 0 0 0 0 0 0 0
0 0 0 0 0 0 0 0 0 0 0
0 0 0 0 0 0 0 0 0 0 0
0 0 0 0 0 0 0 0 0 0 0
0 0 0 0 0 0 0 0 0 0 0
0 0 0 0 0 0 0 0 0 0 0
0 0 0 0 0 0 0 0 0 0 0
0 0 0 0 0 0 0 0 0 0 0
0 0 0 0 0 0 0 0 0 0 0
0 0 0 0 0 0 0 0 0 0 0