MODE 2
SIZE 11/70
LIMIT 0/27
COLOR LIMIT 4
STARS 1000/2000/3000
POWERUPS 0/0/0/0
0 17 17 14 13 14 17 17 0 0 0
0 17 16 14 14 14 16 17 0 0 0
0 0 17 15 15 15 15 15 17 0 0
0 0 17 15 15 15 15 0 17 0 0
0 0 0 18 12 15 12 18 0 0 0
0 0 0 18 12 12 18 0 0 0 0
0 0 0 1 18 12 18 1 0 0 0
0 0 1 1 18 18 1 1 0 0 0
0 0 1 2 1 0 1 2 1 0 0
0 1 1 1 1 1 1 1 1 0 0
0 0 2 2 2 0 2 2 2 0 0
0 4 2 2 4 4 2 2 4 0 0
0 0 4 0 4 0 4 0 4 0 0
0 0 4 4 0 0 4 4 0 0 0
0 0 0 4 0 0 0 4 0 0 0
0 0 6 6 0 6 6 0 6 6 0
0 0 0 6 0 0 6 0 0 6 0
0 0 6 6 0 6 6 0 6 6 0
0 0 0 6 0 0 6 0 0 6 0
0 0 6 6 0 6 6 0 6 6 0
0 0 0 6 0 0 6 0 0 6 0
0 0 6 6 0 6 6 0 6 6 0
0 0 0 6 0 0 6 0 0 6 0
0 0 6 6 0 6 6 0 6 6 0
0 0 0 6 0 0 6 0 0 6 0
0 0 6 0 0 6 0 0 0 6 0
0 0 0 6 0 0 6 0 0 6 0
0 0 0 6 0 0 6 0 6 0 0
0 0 0 0 6 0 0 6 6 0 0
0 0 0 0 6 6 6 6 0 0 0
0 0 0 0 0 0 0 0 0 0 0
0 0 0 0 0 0 0 0 0 0 0
0 0 0 0 0 0 0 0 0 0 0
0 0 0 0 0 0 0 0 0 0 0
0 0 0 0 0 0 0 0 0 0 0
0 0 0 0 0 0 0 0 0 0 0
0 0 0 0 0 0 0 0 0 0 0
0 0 0 0 0 0 0 0 0 0 0
0 0 0 0 0 0 0 0 0 0 0
0 0 0 0 0 0 0 0 0 0 0
0 0 0 0 0 0 0 0 0 0 0
0 0 0 0 0 0 0 0 0 0 0
0 0 0 0 0 0 0 0 0 0 0
0 0 0 0 0 0 0 0 0 0 0
0 0 0 0 0 0 0 0 0 0 0
0 0 0 0 0 0 0 0 0 0 0
0 0 0 0 0 0 0 0 0 0 0
0 0 0 0 0 0 0 0 0 0 0
0 0 0 0 0 0 0 0 0 0 0
0 0 0 0 0 0 0 0 0 0 0
0 0 0 0 0 0 0 0 0 0 0
0 0 0 0 0 0 0 0 0 0 0
0 0 0 0 0 0 0 0 0 0 0
0 0 0 0 0 0 0 0 0 0 0
0 0 0 0 0 0 0 0 0 0 0
0 0 0 0 0 0 0 0 0 0 0
0 0 0 0 0 0 0 0 0 0 0
0 0 0 0 0 0 0 0 0 0 0
0 0 0 0 0 0 0 0 0 0 0
0 0 0 0 0 0 0 0 0 0 0
0 0 0 0 0 0 0 0 0 0 0
0 0 0 0 0 0 0 0 0 0 0
0 0 0 0 0 0 0 0 0 0 0
0 0 0 0 0 0 0 0 0 0 0
0 0 0 0 0 0 0 0 0 0 0
0 0 0 0 0 0 0 0 0 0 0
0 0 0 0 0 0 0 0 0 0 0
0 0 0 0 0 0 0 0 0 0 0
0 0 0 0 0 0 0 0 0 0 0
0 0 0 0 0 0 0 0 0 0 0