MODE 2
SIZE 11/70
LIMIT 0/15
COLOR LIMIT 4
STARS 1000/2000/3000
POWERUPS 1/1/1/1
0 0 17 16 17 17 17 16 17 0 0
0 0 17 16 6 6 16 17 0 0 0
0 0 17 15 16 6 16 15 17 0 0
0 6 14 15 6 6 15 14 6 0 0
0 6 9 14 15 6 15 14 9 6 0
0 6 13 14 6 6 14 13 6 0 0
0 0 6 13 8 6 8 13 6 0 0
0 0 6 13 6 6 13 6 0 0 0
0 0 6 0 0 0 0 0 6 0 0
0 0 6 0 0 0 0 6 0 0 0
0 0 0 6 0 0 0 6 0 0 0
0 0 0 6 0 0 6 0 0 0 0
0 0 0 0 6 0 6 0 0 0 0
0 0 0 6 6 6 6 0 0 0 0
0 0 0 6 0 6 0 6 0 0 0
0 0 6 0 0 0 0 6 0 0 0
0 0 6 6 0 0 0 6 6 0 0
0 6 6 0 0 0 0 6 6 0 0
0 0 6 0 0 0 0 0 6 0 0
0 6 6 0 0 0 0 6 6 0 0
0 0 0 6 0 0 0 6 0 0 0
0 0 6 6 0 0 6 6 0 0 0
0 0 0 6 6 0 6 6 0 0 0
0 0 0 6 0 0 6 0 0 0 0
0 0 0 6 6 0 6 6 0 0 0
0 0 6 0 0 0 0 6 0 0 0
0 0 6 6 0 0 0 6 6 0 0
0 6 6 0 0 0 0 6 6 0 0
0 0 6 0 0 0 0 0 6 0 0
0 0 6 0 0 0 0 6 0 0 0
0 0 0 6 6 6 6 6 0 0 0
0 0 0 6 6 6 6 0 0 0 0
0 0 0 0 6 6 6 0 0 0 0
0 0 0 0 6 6 0 0 0 0 0
0 0 0 0 0 6 0 0 0 0 0
0 0 0 0 0 0 0 0 0 0 0
0 0 0 0 0 0 0 0 0 0 0
0 0 0 0 0 0 0 0 0 0 0
0 0 0 0 0 0 0 0 0 0 0
0 0 0 0 0 0 0 0 0 0 0
0 0 0 0 0 0 0 0 0 0 0
0 0 0 0 0 0 0 0 0 0 0
0 0 0 0 0 0 0 0 0 0 0
0 0 0 0 0 0 0 0 0 0 0
0 0 0 0 0 0 0 0 0 0 0
0 0 0 0 0 0 0 0 0 0 0
0 0 0 0 0 0 0 0 0 0 0
0 0 0 0 0 0 0 0 0 0 0
0 0 0 0 0 0 0 0 0 0 0
0 0 0 0 0 0 0 0 0 0 0
0 0 0 0 0 0 0 0 0 0 0
0 0 0 0 0 0 0 0 0 0 0
0 0 0 0 0 0 0 0 0 0 0
0 0 0 0 0 0 0 0 0 0 0
0 0 0 0 0 0 0 0 0 0 0
0 0 0 0 0 0 0 0 0 0 0
0 0 0 0 0 0 0 0 0 0 0
0 0 0 0 0 0 0 0 0 0 0
0 0 0 0 0 0 0 0 0 0 0
0 0 0 0 0 0 0 0 0 0 0
0 0 0 0 0 0 0 0 0 0 0
0 0 0 0 0 0 0 0 0 0 0
0 0 0 0 0 0 0 0 0 0 0
0 0 0 0 0 0 0 0 0 0 0
0 0 0 0 0 0 0 0 0 0 0
0 0 0 0 0 0 0 0 0 0 0
0 0 0 0 0 0 0 0 0 0 0
0 0 0 0 0 0 0 0 0 0 0
0 0 0 0 0 0 0 0 0 0 0
0 0 0 0 0 0 0 0 0 0 0