MODE 2
SIZE 11/70
LIMIT 0/35
COLOR LIMIT 4
STARS 500/1500/3000
POWERUPS 0/0/0/0
0 0 2 2 6 6 6 2 2 0 0
0 18 11 2 6 6 2 11 18 0 0
0 15 15 11 2 6 2 11 15 15 0
6 6 6 6 6 6 6 6 6 6 0
0 0 6 12 0 0 0 12 6 0 0
0 6 12 4 4 4 4 12 6 0 0
0 6 12 16 16 0 16 16 12 6 0
0 1 13 0 1 1 0 13 1 0 0
0 1 14 13 14 1 14 13 14 1 0
1 0 13 0 0 0 0 13 0 1 0
0 1 0 0 0 0 0 0 0 1 0
0 1 0 0 0 0 0 0 1 0 0
0 6 6 0 0 0 0 0 6 6 0
0 0 6 0 0 0 0 6 0 0 0
0 0 0 6 0 0 0 6 0 0 0
0 6 6 6 0 0 6 6 6 0 0
0 0 6 6 0 0 0 6 6 0 0
0 0 6 0 0 0 0 6 0 0 0
0 0 6 6 0 0 0 6 6 0 0
0 0 6 0 0 0 0 6 0 0 0
0 0 6 6 0 0 0 6 6 0 0
0 0 6 0 0 0 0 6 0 0 0
0 0 6 6 0 0 0 6 6 0 0
0 6 6 6 0 0 6 6 6 0 0
0 0 6 6 0 0 0 6 6 0 0
0 0 6 0 0 0 0 6 0 0 0
0 0 6 6 0 0 0 6 6 0 0
0 0 6 0 0 0 0 6 0 0 0
0 0 6 6 0 0 0 6 6 0 0
0 0 6 0 0 0 0 6 0 0 0
0 0 6 6 0 0 0 6 6 0 0
0 0 0 6 6 6 6 0 0 0 0
0 0 0 0 6 0 6 0 0 0 0
0 0 0 0 6 6 0 0 0 0 0
0 0 0 0 6 6 6 0 0 0 0
0 0 0 6 0 0 6 0 0 0 0
0 0 0 6 0 0 0 6 0 0 0
0 0 6 0 0 0 0 6 0 0 0
0 0 6 0 0 0 0 0 6 0 0
0 0 0 0 0 0 0 0 0 0 0
0 0 0 0 0 0 0 0 0 0 0
0 0 0 0 0 0 0 0 0 0 0
0 0 0 0 0 0 0 0 0 0 0
0 0 0 0 0 0 0 0 0 0 0
0 0 0 0 0 0 0 0 0 0 0
0 0 0 0 0 0 0 0 0 0 0
0 0 0 0 0 0 0 0 0 0 0
0 0 0 0 0 0 0 0 0 0 0
0 0 0 0 0 0 0 0 0 0 0
0 0 0 0 0 0 0 0 0 0 0
0 0 0 0 0 0 0 0 0 0 0
0 0 0 0 0 0 0 0 0 0 0
0 0 0 0 0 0 0 0 0 0 0
0 0 0 0 0 0 0 0 0 0 0
0 0 0 0 0 0 0 0 0 0 0
0 0 0 0 0 0 0 0 0 0 0
0 0 0 0 0 0 0 0 0 0 0
0 0 0 0 0 0 0 0 0 0 0
0 0 0 0 0 0 0 0 0 0 0
0 0 0 0 0 0 0 0 0 0 0
0 0 0 0 0 0 0 0 0 0 0
0 0 0 0 0 0 0 0 0 0 0
0 0 0 0 0 0 0 0 0 0 0
0 0 0 0 0 0 0 0 0 0 0
0 0 0 0 0 0 0 0 0 0 0
0 0 0 0 0 0 0 0 0 0 0
0 0 0 0 0 0 0 0 0 0 0
0 0 0 0 0 0 0 0 0 0 0
0 0 0 0 0 0 0 0 0 0 0
0 0 0 0 0 0 0 0 0 0 0