MODE 2
SIZE 11/70
LIMIT 0/22
COLOR LIMIT 4
STARS 500/1500/3000
POWERUPS 0/0/0/0
0 0 16 6 0 0 0 6 16 0 0
0 17 16 6 0 0 6 16 17 0 0
0 17 16 16 6 0 6 16 16 17 0
0 17 15 15 6 6 15 15 17 0 0
0 0 17 15 0 0 0 15 17 0 0
0 6 14 14 0 0 14 14 6 0 0
0 0 6 14 0 0 0 14 6 0 0
0 18 13 13 18 18 13 13 18 0 0
0 0 18 13 18 0 18 13 18 0 0
0 0 18 18 0 0 18 18 0 0 0
0 0 6 6 6 6 6 6 6 0 0
0 0 6 6 6 6 6 6 0 0 0
0 0 0 6 6 6 6 6 0 0 0
0 0 0 6 6 6 6 0 0 0 0
0 0 0 6 6 6 6 6 0 0 0
0 0 6 0 6 6 0 6 0 0 0
0 0 6 0 0 6 0 0 6 0 0
0 0 6 0 0 0 0 6 0 0 0
0 0 0 6 6 6 6 6 0 0 0
0 0 0 6 6 6 6 0 0 0 0
0 0 0 0 6 6 6 0 0 0 0
0 0 0 0 6 6 0 0 0 0 0
0 0 0 0 0 6 0 0 0 0 0
0 0 0 0 0 0 0 0 0 0 0
0 0 0 0 0 0 0 0 0 0 0
0 0 0 0 0 0 0 0 0 0 0
0 0 0 0 0 0 0 0 0 0 0
0 0 0 0 0 0 0 0 0 0 0
0 0 0 0 0 0 0 0 0 0 0
0 0 0 0 0 0 0 0 0 0 0
0 0 0 0 0 0 0 0 0 0 0
0 0 0 0 0 0 0 0 0 0 0
0 0 0 0 0 0 0 0 0 0 0
0 0 0 0 0 0 0 0 0 0 0
0 0 0 0 0 0 0 0 0 0 0
0 0 0 0 0 0 0 0 0 0 0
0 0 0 0 0 0 0 0 0 0 0
0 0 0 0 0 0 0 0 0 0 0
0 0 0 0 0 0 0 0 0 0 0
0 0 0 0 0 0 0 0 0 0 0
0 0 0 0 0 0 0 0 0 0 0
0 0 0 0 0 0 0 0 0 0 0
0 0 0 0 0 0 0 0 0 0 0
0 0 0 0 0 0 0 0 0 0 0
0 0 0 0 0 0 0 0 0 0 0
0 0 0 0 0 0 0 0 0 0 0
0 0 0 0 0 0 0 0 0 0 0
0 0 0 0 0 0 0 0 0 0 0
0 0 0 0 0 0 0 0 0 0 0
0 0 0 0 0 0 0 0 0 0 0
0 0 0 0 0 0 0 0 0 0 0
0 0 0 0 0 0 0 0 0 0 0
0 0 0 0 0 0 0 0 0 0 0
0 0 0 0 0 0 0 0 0 0 0
0 0 0 0 0 0 0 0 0 0 0
0 0 0 0 0 0 0 0 0 0 0
0 0 0 0 0 0 0 0 0 0 0
0 0 0 0 0 0 0 0 0 0 0
0 0 0 0 0 0 0 0 0 0 0
0 0 0 0 0 0 0 0 0 0 0
0 0 0 0 0 0 0 0 0 0 0
0 0 0 0 0 0 0 0 0 0 0
0 0 0 0 0 0 0 0 0 0 0
0 0 0 0 0 0 0 0 0 0 0
0 0 0 0 0 0 0 0 0 0 0
0 0 0 0 0 0 0 0 0 0 0
0 0 0 0 0 0 0 0 0 0 0
0 0 0 0 0 0 0 0 0 0 0
0 0 0 0 0 0 0 0 0 0 0
0 0 0 0 0 0 0 0 0 0 0