MODE 2
SIZE 11/70
LIMIT 0/20
COLOR LIMIT 4
STARS 1000/2000/3000
POWERUPS 0/0/0/0
0 0 17 14 4 4 4 4 14 17 0
0 0 17 4 4 4 4 4 17 0 0
0 0 17 3 3 13 13 3 3 17 0
0 0 17 17 17 17 17 17 17 0 0
0 0 0 5 5 5 5 5 5 0 0
0 0 1 1 1 5 5 5 6 6 0
0 0 3 3 2 2 2 7 7 6 0
0 18 3 1 2 2 15 7 18 0 0
0 0 18 1 1 12 5 5 18 0 0
0 0 18 18 18 18 18 18 0 0 0
0 0 9 9 9 9 9 9 9 0 0
0 0 9 9 9 9 9 9 0 0 0
0 0 0 9 9 13 9 9 0 0 0
0 0 0 9 9 9 9 0 0 0 0
0 0 0 0 9 9 9 0 0 0 0
0 0 0 0 9 9 0 0 0 0 0
0 0 0 0 0 9 0 0 0 0 0
0 0 6 6 16 16 6 6 6 0 0
0 0 4 4 1 11 1 4 4 0 0
0 0 4 14 1 1 14 4 0 0 0
0 0 0 4 4 11 4 4 0 0 0
0 5 5 5 5 5 5 5 5 0 0
0 0 5 4 4 14 4 4 5 0 0
0 0 5 3 3 3 3 5 0 0 0
0 0 0 5 2 2 2 5 0 0 0
0 0 0 5 1 1 5 0 0 0 0
0 0 0 0 5 1 5 0 0 0 0
0 0 0 0 5 5 0 0 0 0 0
0 0 18 18 18 15 18 18 18 0 0
0 0 4 18 18 18 18 18 4 0 0
0 0 4 4 4 4 4 4 4 4 0
0 0 4 4 4 4 4 4 4 0 0
0 0 0 0 0 0 0 0 0 0 0
0 0 0 0 0 0 0 0 0 0 0
0 0 0 0 0 0 0 0 0 0 0
0 0 0 0 0 0 0 0 0 0 0
0 0 0 0 0 0 0 0 0 0 0
0 0 0 0 0 0 0 0 0 0 0
0 0 0 0 0 0 0 0 0 0 0
0 0 0 0 0 0 0 0 0 0 0
0 0 0 0 0 0 0 0 0 0 0
0 0 0 0 0 0 0 0 0 0 0
0 0 0 0 0 0 0 0 0 0 0
0 0 0 0 0 0 0 0 0 0 0
0 0 0 0 0 0 0 0 0 0 0
0 0 0 0 0 0 0 0 0 0 0
0 0 0 0 0 0 0 0 0 0 0
0 0 0 0 0 0 0 0 0 0 0
0 0 0 0 0 0 0 0 0 0 0
0 0 0 0 0 0 0 0 0 0 0
0 0 0 0 0 0 0 0 0 0 0
0 0 0 0 0 0 0 0 0 0 0
0 0 0 0 0 0 0 0 0 0 0
0 0 0 0 0 0 0 0 0 0 0
0 0 0 0 0 0 0 0 0 0 0
0 0 0 0 0 0 0 0 0 0 0
0 0 0 0 0 0 0 0 0 0 0
0 0 0 0 0 0 0 0 0 0 0
0 0 0 0 0 0 0 0 0 0 0
0 0 0 0 0 0 0 0 0 0 0
0 0 0 0 0 0 0 0 0 0 0
0 0 0 0 0 0 0 0 0 0 0
0 0 0 0 0 0 0 0 0 0 0
0 0 0 0 0 0 0 0 0 0 0
0 0 0 0 0 0 0 0 0 0 0
0 0 0 0 0 0 0 0 0 0 0
0 0 0 0 0 0 0 0 0 0 0
0 0 0 0 0 0 0 0 0 0 0
0 0 0 0 0 0 0 0 0 0 0
0 0 0 0 0 0 0 0 0 0 0