MODE 2
SIZE 11/70
LIMIT 0/29
COLOR LIMIT 5
STARS 600/2300/4800
POWERUPS 0/0/0/0
14 10 0 0 0 0 0 0 0 10 13
16 6 6 6 6 6 6 6 6 6 16
16 6 6 6 6 9 6 6 6 6 16
16 6 6 6 7 6 6 6 6 6 16
16 0 0 0 0 0 0 0 0 0 16
11 10 0 0 0 0 0 0 0 10 12
16 6 6 6 6 9 6 6 6 6 16
16 6 6 6 6 6 6 6 6 6 16
16 6 7 6 6 6 6 6 6 6 16
16 0 0 0 0 0 0 0 0 0 16
11 10 0 0 0 0 0 0 0 10 12
16 6 6 6 9 6 6 6 6 6 16
16 6 6 6 6 6 6 6 6 6 16
16 6 6 6 6 6 7 6 6 6 16
16 0 0 0 0 0 0 0 0 0 16
13 10 0 0 0 0 0 0 0 10 14
16 6 6 6 6 9 6 6 6 6 16
16 6 6 6 6 6 6 6 6 6 16
16 6 6 6 6 6 6 6 6 6 16
16 0 0 0 0 0 0 0 0 0 16
16 0 0 0 0 0 0 0 0 0 16
16 0 0 0 0 0 0 0 0 0 16
16 0 0 0 0 0 0 0 0 0 16
16 0 0 0 0 0 0 0 0 0 16
16 0 0 0 0 0 0 0 0 0 16
16 0 0 0 0 0 0 0 0 0 16
0 0 0 0 0 0 0 0 0 0 0
0 0 0 0 0 0 0 0 0 0 0
0 0 0 0 0 0 0 0 0 0 0
0 0 0 0 0 0 0 0 0 0 0
0 0 0 0 0 0 0 0 0 0 0
0 0 0 0 0 0 0 0 0 0 0
0 0 0 0 0 0 0 0 0 0 0
0 0 0 0 0 0 0 0 0 0 0
0 0 0 0 0 0 0 0 0 0 0
0 0 0 0 0 0 0 0 0 0 0
0 0 0 0 0 0 0 0 0 0 0
0 0 0 0 0 0 0 0 0 0 0
0 0 0 0 0 0 0 0 0 0 0
0 0 0 0 0 0 0 0 0 0 0
0 0 0 0 0 0 0 0 0 0 0
0 0 0 0 0 0 0 0 0 0 0
0 0 0 0 0 0 0 0 0 0 0
0 0 0 0 0 0 0 0 0 0 0
0 0 0 0 0 0 0 0 0 0 0
0 0 0 0 0 0 0 0 0 0 0
0 0 0 0 0 0 0 0 0 0 0
0 0 0 0 0 0 0 0 0 0 0
0 0 0 0 0 0 0 0 0 0 0
0 0 0 0 0 0 0 0 0 0 0
0 0 0 0 0 0 0 0 0 0 0
0 0 0 0 0 0 0 0 0 0 0
0 0 0 0 0 0 0 0 0 0 0
0 0 0 0 0 0 0 0 0 0 0
0 0 0 0 0 0 0 0 0 0 0
0 0 0 0 0 0 0 0 0 0 0
0 0 0 0 0 0 0 0 0 0 0
0 0 0 0 0 0 0 0 0 0 0
0 0 0 0 0 0 0 0 0 0 0
0 0 0 0 0 0 0 0 0 0 0
0 0 0 0 0 0 0 0 0 0 0
0 0 0 0 0 0 0 0 0 0 0
0 0 0 0 0 0 0 0 0 0 0
0 0 0 0 0 0 0 0 0 0 0
0 0 0 0 0 0 0 0 0 0 0
0 0 0 0 0 0 0 0 0 0 0
0 0 0 0 0 0 0 0 0 0 0
0 0 0 0 0 0 0 0 0 0 0
0 0 0 0 0 0 0 0 0 0 0
0 0 0 0 0 0 0 0 0 0 0