MODE 2
SIZE 11/70
LIMIT 0/31
COLOR LIMIT 5
STARS 1200/7500/16000
POWERUPS 0/0/0/0
6 6 11 6 6 12 6 6 14 6 6
6 6 6 6 6 6 6 6 6 6 6
6 6 6 6 6 6 7 6 6 6 6
1 6 6 6 6 6 6 6 6 6 6
1 7 7 2 6 6 6 4 4 7 7
1 1 2 2 2 7 7 4 6 6 6
17 17 1 17 17 2 17 17 4 17 17
17 1 17 17 2 17 17 4 17 17 17
17 17 1 17 17 2 17 17 4 17 17
7 7 1 7 2 18 7 4 18 7 7
7 7 1 7 7 2 7 7 4 7 7
1 1 2 2 2 7 7 7 4 4 4
6 6 6 6 6 6 6 6 6 6 6
6 6 6 6 6 6 6 6 6 6 6
17 17 17 17 17 17 17 17 17 17 17
6 6 4 6 6 6 6 6 6 6 6
6 6 6 4 6 6 6 6 6 6 6
6 6 4 6 7 1 1 1 2 2 2
17 17 4 17 17 1 17 17 2 17 17
17 4 17 17 1 17 17 2 17 17 17
17 17 4 17 17 1 17 17 2 17 17
4 4 7 1 1 1 2 2 2 6 7
6 6 6 6 6 6 6 6 6 6 6
6 6 6 6 6 6 6 6 6 6 6
6 6 6 2 2 4 6 1 6 2 6
6 16 2 16 4 16 1 16 2 16 6
6 16 2 16 4 16 1 16 2 16 6
16 2 16 4 16 1 16 2 16 6 6
2 2 7 4 4 1 1 1 1 1 1
17 17 17 17 17 17 17 17 17 18 17
0 0 0 0 0 0 0 0 0 0 0
0 0 0 0 0 0 0 0 0 0 0
0 0 0 0 0 0 0 0 0 0 0
0 0 0 0 0 0 0 0 0 0 0
0 0 0 0 0 0 0 0 0 0 0
0 0 0 0 0 0 0 0 0 0 0
0 0 0 0 0 0 0 0 0 0 0
0 0 0 0 0 0 0 0 0 0 0
0 0 0 0 0 0 0 0 0 0 0
0 0 0 0 0 0 0 0 0 0 0
0 0 0 0 0 0 0 0 0 0 0
0 0 0 0 0 0 0 0 0 0 0
0 0 0 0 0 0 0 0 0 0 0
0 0 0 0 0 0 0 0 0 0 0
0 0 0 0 0 0 0 0 0 0 0
0 0 0 0 0 0 0 0 0 0 0
0 0 0 0 0 0 0 0 0 0 0
0 0 0 0 0 0 0 0 0 0 0
0 0 0 0 0 0 0 0 0 0 0
0 0 0 0 0 0 0 0 0 0 0
0 0 0 0 0 0 0 0 0 0 0
0 0 0 0 0 0 0 0 0 0 0
0 0 0 0 0 0 0 0 0 0 0
0 0 0 0 0 0 0 0 0 0 0
0 0 0 0 0 0 0 0 0 0 0
0 0 0 0 0 0 0 0 0 0 0
0 0 0 0 0 0 0 0 0 0 0
0 0 0 0 0 0 0 0 0 0 0
0 0 0 0 0 0 0 0 0 0 0
0 0 0 0 0 0 0 0 0 0 0
0 0 0 0 0 0 0 0 0 0 0
0 0 0 0 0 0 0 0 0 0 0
0 0 0 0 0 0 0 0 0 0 0
0 0 0 0 0 0 0 0 0 0 0
0 0 0 0 0 0 0 0 0 0 0
0 0 0 0 0 0 0 0 0 0 0
0 0 0 0 0 0 0 0 0 0 0
0 0 0 0 0 0 0 0 0 0 0
0 0 0 0 0 0 0 0 0 0 0
0 0 0 0 0 0 0 0 0 0 0