MODE 2
SIZE 11/70
LIMIT 0/25
COLOR LIMIT 5
STARS 700/3100/4500
POWERUPS 0/0/0/0
0 6 6 6 6 0 0 6 13 6 6
0 6 6 6 6 0 6 6 6 6 0
0 0 16 9 6 6 6 6 9 16 0
0 0 16 16 0 0 0 16 16 0 0
0 0 6 12 6 0 0 6 6 6 6
0 0 6 6 0 0 0 6 6 6 0
0 0 0 6 6 0 0 6 6 0 0
0 0 16 9 6 0 6 9 16 0 0
0 0 0 16 16 0 0 16 16 0 0
0 0 0 6 6 0 6 12 0 0 0
0 0 0 6 6 6 6 6 6 0 0
0 0 0 6 6 0 6 6 0 0 0
0 0 0 0 0 6 6 0 0 0 0
0 0 0 0 6 8 16 0 0 0 0
0 0 0 0 0 16 16 0 0 0 0
0 0 0 0 6 11 6 0 0 0 0
0 0 0 0 0 6 6 0 0 0 0
0 0 0 0 16 8 6 0 0 0 0
0 0 0 0 0 16 16 0 0 0 0
0 0 0 0 6 6 6 0 0 0 0
0 0 0 0 0 6 6 0 0 0 0
0 0 0 0 6 8 16 0 0 0 0
0 0 0 0 0 16 16 0 0 0 0
0 0 0 0 6 11 6 0 0 0 0
0 0 0 0 0 6 6 0 0 0 0
0 0 0 0 16 16 7 0 0 0 0
0 0 0 0 0 16 16 0 0 0 0
0 0 0 0 6 6 6 0 0 0 0
0 0 0 0 0 6 6 0 0 0 0
0 0 0 0 6 8 17 0 0 0 0
0 0 0 0 0 17 17 0 0 0 0
0 0 0 0 6 14 6 0 0 0 0
0 0 0 0 0 6 6 0 0 0 0
0 0 0 0 16 8 6 0 0 0 0
0 0 0 0 0 16 16 0 0 0 0
0 0 0 0 6 6 6 0 0 0 0
0 0 0 0 0 6 6 0 0 0 0
0 0 0 0 6 8 16 0 0 0 0
0 0 0 0 0 16 16 0 0 0 0
0 0 0 0 6 14 6 0 0 0 0
0 0 0 0 0 6 6 0 0 0 0
0 0 0 0 16 8 6 0 0 0 0
0 0 0 0 0 16 16 0 0 0 0
0 0 0 0 6 13 6 0 0 0 0
0 0 0 0 0 6 6 0 0 0 0
0 0 0 0 6 8 16 0 0 0 0
0 0 0 0 0 16 16 0 0 0 0
0 0 0 0 0 0 0 0 0 0 0
0 0 0 0 0 0 0 0 0 0 0
0 0 0 0 0 0 0 0 0 0 0
0 0 0 0 0 0 0 0 0 0 0
0 0 0 0 0 0 0 0 0 0 0
0 0 0 0 0 0 0 0 0 0 0
0 0 0 0 0 0 0 0 0 0 0
0 0 0 0 0 0 0 0 0 0 0
0 0 0 0 0 0 0 0 0 0 0
0 0 0 0 0 0 0 0 0 0 0
0 0 0 0 0 0 0 0 0 0 0
0 0 0 0 0 0 0 0 0 0 0
0 0 0 0 0 0 0 0 0 0 0
0 0 0 0 0 0 0 0 0 0 0
0 0 0 0 0 0 0 0 0 0 0
0 0 0 0 0 0 0 0 0 0 0
0 0 0 0 0 0 0 0 0 0 0
0 0 0 0 0 0 0 0 0 0 0
0 0 0 0 0 0 0 0 0 0 0
0 0 0 0 0 0 0 0 0 0 0
0 0 0 0 0 0 0 0 0 0 0
0 0 0 0 0 0 0 0 0 0 0
0 0 0 0 0 0 0 0 0 0 0