MODE 2
SIZE 11/70
LIMIT 0/26
COLOR LIMIT 5
STARS 600/2800/5400
POWERUPS 0/0/0/0
6 6 6 6 6 6 6 4 6 6 13
6 6 11 6 8 6 6 6 6 6 6
0 0 0 0 0 0 0 0 6 6 6
0 0 0 0 0 0 0 6 6 6 0
6 6 6 6 6 6 6 6 6 6 0
6 6 6 6 8 12 6 6 6 0 0
0 6 7 6 0 0 0 0 0 0 0
0 6 6 6 0 0 0 0 0 0 0
0 0 6 6 6 6 6 6 6 6 6
0 0 13 6 8 6 6 6 6 6 6
0 0 0 0 0 0 0 0 6 6 6
0 0 0 0 0 0 0 6 8 6 0
9 6 6 6 6 6 6 6 6 6 0
6 6 6 6 6 6 6 6 11 0 0
0 6 7 6 0 0 0 0 0 0 0
0 6 6 6 0 0 0 0 0 0 0
0 0 6 6 6 6 6 6 6 6 6
0 0 6 8 6 12 6 6 6 6 6
0 0 0 0 0 0 0 0 6 6 6
0 0 0 0 0 0 0 6 6 6 0
6 6 6 6 11 6 6 6 6 9 0
6 6 6 6 6 6 6 6 13 0 0
0 6 7 6 0 0 0 0 0 0 0
0 6 6 6 0 0 0 0 0 0 0
0 0 6 6 6 6 6 6 6 6 6
0 0 6 8 6 12 6 6 6 6 6
0 0 0 0 0 0 0 0 6 6 6
0 0 0 0 0 0 0 6 6 6 0
6 9 6 6 6 6 6 6 6 6 0
6 6 6 6 6 6 11 6 6 0 0
0 6 7 6 0 0 0 0 0 0 0
0 6 6 6 0 0 0 0 0 0 0
0 0 6 6 6 6 6 6 6 6 6
0 0 6 6 6 12 6 6 6 6 6
0 0 0 0 0 0 0 0 6 6 6
0 0 0 0 0 0 0 6 6 6 0
6 6 6 6 6 11 6 6 6 6 0
6 6 6 6 6 6 6 6 6 0 0
0 6 7 6 0 0 0 0 0 0 0
0 6 6 6 0 0 0 0 0 0 0
0 0 6 6 6 6 6 6 6 6 9
0 0 6 8 6 6 6 6 6 6 6
0 0 0 0 0 0 0 0 6 7 6
0 0 0 0 0 0 0 6 6 6 0
9 6 6 6 11 6 6 6 6 6 0
6 6 6 6 6 6 6 8 6 0 0
0 0 0 0 0 0 0 0 0 0 0
0 0 0 0 0 0 0 0 0 0 0
0 0 0 0 0 0 0 0 0 0 0
0 0 0 0 0 0 0 0 0 0 0
0 0 0 0 0 0 0 0 0 0 0
0 0 0 0 0 0 0 0 0 0 0
0 0 0 0 0 0 0 0 0 0 0
0 0 0 0 0 0 0 0 0 0 0
0 0 0 0 0 0 0 0 0 0 0
0 0 0 0 0 0 0 0 0 0 0
0 0 0 0 0 0 0 0 0 0 0
0 0 0 0 0 0 0 0 0 0 0
0 0 0 0 0 0 0 0 0 0 0
0 0 0 0 0 0 0 0 0 0 0
0 0 0 0 0 0 0 0 0 0 0
0 0 0 0 0 0 0 0 0 0 0
0 0 0 0 0 0 0 0 0 0 0
0 0 0 0 0 0 0 0 0 0 0
0 0 0 0 0 0 0 0 0 0 0
0 0 0 0 0 0 0 0 0 0 0
0 0 0 0 0 0 0 0 0 0 0
0 0 0 0 0 0 0 0 0 0 0
0 0 0 0 0 0 0 0 0 0 0
0 0 0 0 0 0 0 0 0 0 0