MODE 2
SIZE 11/70
LIMIT 0/40
COLOR LIMIT 5
STARS 500/1200/2300
POWERUPS 0/0/0/0
0 6 6 0 6 6 6 0 6 6 0
6 8 6 0 6 6 0 6 11 6 0
0 6 6 0 6 10 6 0 6 6 0
6 6 6 0 6 6 0 6 6 6 0
0 6 6 0 6 12 6 0 6 6 0
6 14 6 0 6 6 0 6 8 6 0
0 6 6 0 6 7 6 0 6 6 0
6 7 6 0 6 6 0 6 6 6 0
0 6 6 0 6 10 6 0 6 6 0
6 8 6 0 6 6 0 6 7 6 0
0 6 6 0 6 6 6 0 6 6 0
6 6 6 0 6 6 0 6 6 6 0
0 0 6 11 6 0 6 6 6 0 0
0 0 6 6 0 0 6 6 0 0 0
0 0 6 6 6 10 6 6 6 0 0
0 0 12 6 0 0 6 6 0 0 0
0 0 6 6 6 16 6 8 6 0 0
0 0 6 6 0 0 6 6 0 0 0
0 0 6 7 6 10 6 7 6 0 0
0 0 6 6 0 0 6 6 0 0 0
0 0 6 8 6 16 6 6 6 0 0
0 0 6 6 0 0 14 6 0 0 0
0 0 6 6 6 10 6 6 6 0 0
0 0 12 6 0 0 6 6 0 0 0
0 0 6 6 6 16 6 11 6 0 0
0 0 6 6 16 0 6 6 0 0 0
0 0 6 7 6 16 6 8 6 0 0
0 0 6 6 0 0 6 6 0 0 0
0 0 6 6 6 10 6 6 6 0 0
0 0 6 6 0 0 6 6 0 0 0
0 0 6 8 6 16 6 6 6 0 0
0 0 6 6 0 0 6 6 0 0 0
0 0 6 14 6 16 6 7 6 0 0
0 0 6 6 0 0 6 6 0 0 0
0 0 0 6 0 0 0 6 0 0 0
0 0 1 1 0 0 5 5 0 0 0
0 0 1 1 1 16 5 5 5 0 0
0 0 1 1 0 0 5 5 0 0 0
0 0 0 0 0 0 0 0 0 0 0
0 0 0 0 0 0 0 0 0 0 0
0 0 0 0 0 0 0 0 0 0 0
0 0 0 0 0 0 0 0 0 0 0
0 0 0 0 0 0 0 0 0 0 0
0 0 0 0 0 0 0 0 0 0 0
0 0 0 0 0 0 0 0 0 0 0
0 0 0 0 0 0 0 0 0 0 0
0 0 0 0 0 0 0 0 0 0 0
0 0 0 0 0 0 0 0 0 0 0
0 0 0 0 0 0 0 0 0 0 0
0 0 0 0 0 0 0 0 0 0 0
0 0 0 0 0 0 0 0 0 0 0
0 0 0 0 0 0 0 0 0 0 0
0 0 0 0 0 0 0 0 0 0 0
0 0 0 0 0 0 0 0 0 0 0
0 0 0 0 0 0 0 0 0 0 0
0 0 0 0 0 0 0 0 0 0 0
0 0 0 0 0 0 0 0 0 0 0
0 0 0 0 0 0 0 0 0 0 0
0 0 0 0 0 0 0 0 0 0 0
0 0 0 0 0 0 0 0 0 0 0
0 0 0 0 0 0 0 0 0 0 0
0 0 0 0 0 0 0 0 0 0 0
0 0 0 0 0 0 0 0 0 0 0
0 0 0 0 0 0 0 0 0 0 0
0 0 0 0 0 0 0 0 0 0 0
0 0 0 0 0 0 0 0 0 0 0
0 0 0 0 0 0 0 0 0 0 0
0 0 0 0 0 0 0 0 0 0 0
0 0 0 0 0 0 0 0 0 0 0
0 0 0 0 0 0 0 0 0 0 0