MODE 2
SIZE 11/70
LIMIT 0/32
COLOR LIMIT 5
STARS 1200/3100/6700
POWERUPS 0/0/0/0
2 2 2 0 2 11 2 0 2 2 2
1 1 1 2 17 17 2 1 1 1 0
17 17 17 0 2 11 2 0 17 17 17
16 16 16 0 2 2 0 0 16 16 16
2 2 2 0 4 17 4 0 2 2 2
1 1 1 4 17 17 4 1 1 1 0
17 17 17 0 4 13 4 0 17 17 17
16 16 16 0 4 4 0 0 16 16 16
2 2 2 0 5 14 5 0 2 2 2
1 1 1 5 17 7 5 1 1 1 0
17 17 17 0 5 14 5 0 17 17 17
16 16 16 0 5 5 0 0 16 16 16
2 2 2 0 3 17 3 0 2 2 2
1 1 1 3 17 17 3 1 1 1 0
17 17 17 0 3 12 3 0 17 17 17
16 16 16 0 3 3 0 0 16 16 16
2 2 2 0 2 10 2 0 2 2 2
1 1 1 2 7 7 2 1 1 1 0
17 17 17 0 2 11 2 0 17 17 17
16 16 16 0 2 2 0 0 16 16 16
2 2 2 0 4 7 4 0 2 2 2
1 1 1 4 18 18 4 1 1 1 0
18 18 18 0 4 13 4 0 18 18 18
16 16 16 0 4 4 0 0 16 16 16
0 0 0 0 0 0 0 0 0 0 0
0 0 0 0 0 0 0 0 0 0 0
0 0 0 0 0 0 0 0 0 0 0
0 0 0 0 0 0 0 0 0 0 0
0 0 0 0 0 0 0 0 0 0 0
0 0 0 0 0 0 0 0 0 0 0
0 0 0 0 0 0 0 0 0 0 0
0 0 0 0 0 0 0 0 0 0 0
0 0 0 0 0 0 0 0 0 0 0
0 0 0 0 0 0 0 0 0 0 0
0 0 0 0 0 0 0 0 0 0 0
0 0 0 0 0 0 0 0 0 0 0
0 0 0 0 0 0 0 0 0 0 0
0 0 0 0 0 0 0 0 0 0 0
0 0 0 0 0 0 0 0 0 0 0
0 0 0 0 0 0 0 0 0 0 0
0 0 0 0 0 0 0 0 0 0 0
0 0 0 0 0 0 0 0 0 0 0
0 0 0 0 0 0 0 0 0 0 0
0 0 0 0 0 0 0 0 0 0 0
0 0 0 0 0 0 0 0 0 0 0
0 0 0 0 0 0 0 0 0 0 0
0 0 0 0 0 0 0 0 0 0 0
0 0 0 0 0 0 0 0 0 0 0
0 0 0 0 0 0 0 0 0 0 0
0 0 0 0 0 0 0 0 0 0 0
0 0 0 0 0 0 0 0 0 0 0
0 0 0 0 0 0 0 0 0 0 0
0 0 0 0 0 0 0 0 0 0 0
0 0 0 0 0 0 0 0 0 0 0
0 0 0 0 0 0 0 0 0 0 0
0 0 0 0 0 0 0 0 0 0 0
0 0 0 0 0 0 0 0 0 0 0
0 0 0 0 0 0 0 0 0 0 0
0 0 0 0 0 0 0 0 0 0 0
0 0 0 0 0 0 0 0 0 0 0
0 0 0 0 0 0 0 0 0 0 0
0 0 0 0 0 0 0 0 0 0 0
0 0 0 0 0 0 0 0 0 0 0
0 0 0 0 0 0 0 0 0 0 0
0 0 0 0 0 0 0 0 0 0 0
0 0 0 0 0 0 0 0 0 0 0
0 0 0 0 0 0 0 0 0 0 0
0 0 0 0 0 0 0 0 0 0 0
0 0 0 0 0 0 0 0 0 0 0
0 0 0 0 0 0 0 0 0 0 0