MODE 2
SIZE 11/70
LIMIT 0/26
COLOR LIMIT 5
STARS 500/2100/3600
POWERUPS 0/0/0/0
0 6 6 0 0 6 6 0 0 6 6
6 14 6 0 6 10 6 0 6 12 6
0 6 6 0 0 17 17 0 0 6 6
0 2 2 18 0 0 0 18 17 17 0
0 0 0 18 18 0 0 18 18 0 0
0 0 0 18 0 0 0 18 0 0 0
0 6 6 17 17 6 6 2 2 6 6
6 11 6 0 6 9 6 0 6 8 6
0 6 6 0 0 6 6 0 0 6 6
0 2 2 6 0 0 0 6 17 17 0
0 0 0 6 6 0 0 6 6 0 0
0 0 0 6 0 0 0 6 0 0 0
0 6 6 17 17 6 6 2 2 6 6
6 6 6 0 6 12 6 0 6 13 6
0 6 6 0 0 6 6 0 0 6 6
0 2 2 18 0 0 0 18 17 17 0
0 0 0 18 18 0 0 18 18 0 0
0 0 0 18 0 0 0 18 0 0 0
0 6 6 17 17 6 6 2 2 6 6
6 13 6 0 6 11 6 0 6 7 6
0 6 6 0 0 6 6 0 0 6 6
0 0 0 0 0 0 0 0 0 0 0
0 0 0 0 0 0 0 0 0 0 0
0 0 0 0 0 0 0 0 0 0 0
0 0 0 0 0 0 0 0 0 0 0
0 0 0 0 0 0 0 0 0 0 0
0 0 0 0 0 0 0 0 0 0 0
0 0 0 0 0 0 0 0 0 0 0
0 0 0 0 0 0 0 0 0 0 0
0 0 0 0 0 0 0 0 0 0 0
0 0 0 0 0 0 0 0 0 0 0
0 0 0 0 0 0 0 0 0 0 0
0 0 0 0 0 0 0 0 0 0 0
0 0 0 0 0 0 0 0 0 0 0
0 0 0 0 0 0 0 0 0 0 0
0 0 0 0 0 0 0 0 0 0 0
0 0 0 0 0 0 0 0 0 0 0
0 0 0 0 0 0 0 0 0 0 0
0 0 0 0 0 0 0 0 0 0 0
0 0 0 0 0 0 0 0 0 0 0
0 0 0 0 0 0 0 0 0 0 0
0 0 0 0 0 0 0 0 0 0 0
0 0 0 0 0 0 0 0 0 0 0
0 0 0 0 0 0 0 0 0 0 0
0 0 0 0 0 0 0 0 0 0 0
0 0 0 0 0 0 0 0 0 0 0
0 0 0 0 0 0 0 0 0 0 0
0 0 0 0 0 0 0 0 0 0 0
0 0 0 0 0 0 0 0 0 0 0
0 0 0 0 0 0 0 0 0 0 0
0 0 0 0 0 0 0 0 0 0 0
0 0 0 0 0 0 0 0 0 0 0
0 0 0 0 0 0 0 0 0 0 0
0 0 0 0 0 0 0 0 0 0 0
0 0 0 0 0 0 0 0 0 0 0
0 0 0 0 0 0 0 0 0 0 0
0 0 0 0 0 0 0 0 0 0 0
0 0 0 0 0 0 0 0 0 0 0
0 0 0 0 0 0 0 0 0 0 0
0 0 0 0 0 0 0 0 0 0 0
0 0 0 0 0 0 0 0 0 0 0
0 0 0 0 0 0 0 0 0 0 0
0 0 0 0 0 0 0 0 0 0 0
0 0 0 0 0 0 0 0 0 0 0
0 0 0 0 0 0 0 0 0 0 0
0 0 0 0 0 0 0 0 0 0 0
0 0 0 0 0 0 0 0 0 0 0
0 0 0 0 0 0 0 0 0 0 0
0 0 0 0 0 0 0 0 0 0 0
0 0 0 0 0 0 0 0 0 0 0