MODE 2
SIZE 11/70
LIMIT 0/25
COLOR LIMIT 5
STARS 800/2300/5500
POWERUPS 0/0/0/0
6 6 6 6 6 6 6 6 6 6 6
6 6 6 6 6 14 6 6 6 6 6
6 6 6 0 0 0 0 0 0 0 0
6 6 6 0 0 0 0 0 0 0 0
0 6 6 9 0 0 0 0 0 0 0
0 6 6 6 6 1 6 6 6 6 14
0 0 6 6 6 6 1 6 6 6 6
0 0 0 0 0 0 0 0 6 6 6
0 0 0 0 0 0 0 0 6 6 6
0 0 0 0 0 0 0 9 6 6 0
6 6 6 6 2 6 6 6 6 6 0
6 11 6 6 2 6 6 6 6 0 0
6 6 6 0 0 0 0 0 0 0 0
6 6 6 0 0 0 0 0 0 0 0
0 6 6 9 0 0 0 0 0 0 0
0 6 6 6 6 1 6 6 6 6 6
0 0 6 13 6 6 1 6 6 6 6
0 0 0 0 0 0 0 0 6 6 6
0 0 0 0 0 0 0 0 6 6 6
0 0 0 0 0 0 0 9 6 6 0
6 6 6 6 2 6 6 6 6 6 0
6 11 6 6 2 6 6 6 6 0 0
6 6 6 0 0 0 0 0 0 0 0
6 6 6 0 0 0 0 0 0 0 0
0 6 6 9 0 0 0 0 0 0 0
0 6 6 6 6 1 6 6 6 13 6
0 0 6 6 6 6 1 6 6 6 6
0 0 0 0 0 0 0 0 6 6 6
0 0 0 0 0 0 0 0 6 6 6
0 0 0 0 0 0 0 9 6 6 0
6 6 6 6 2 6 6 6 6 6 0
12 6 6 6 2 6 6 6 6 0 0
6 6 6 0 0 0 0 0 0 0 0
6 6 6 0 0 0 0 0 0 0 0
0 6 6 9 0 0 0 0 0 0 0
0 6 6 6 6 1 6 6 6 6 11
0 0 6 6 6 6 1 6 6 6 6
0 0 0 0 0 0 0 0 6 6 6
0 0 0 0 0 0 0 0 6 6 6
0 0 0 0 0 0 0 9 6 6 0
12 6 6 2 6 6 6 6 6 6 0
6 6 6 2 6 6 6 6 7 0 0
0 0 0 0 0 0 0 0 0 0 0
0 0 0 0 0 0 0 0 0 0 0
0 0 0 0 0 0 0 0 0 0 0
0 0 0 0 0 0 0 0 0 0 0
0 0 0 0 0 0 0 0 0 0 0
0 0 0 0 0 0 0 0 0 0 0
0 0 0 0 0 0 0 0 0 0 0
0 0 0 0 0 0 0 0 0 0 0
0 0 0 0 0 0 0 0 0 0 0
0 0 0 0 0 0 0 0 0 0 0
0 0 0 0 0 0 0 0 0 0 0
0 0 0 0 0 0 0 0 0 0 0
0 0 0 0 0 0 0 0 0 0 0
0 0 0 0 0 0 0 0 0 0 0
0 0 0 0 0 0 0 0 0 0 0
0 0 0 0 0 0 0 0 0 0 0
0 0 0 0 0 0 0 0 0 0 0
0 0 0 0 0 0 0 0 0 0 0
0 0 0 0 0 0 0 0 0 0 0
0 0 0 0 0 0 0 0 0 0 0
0 0 0 0 0 0 0 0 0 0 0
0 0 0 0 0 0 0 0 0 0 0
0 0 0 0 0 0 0 0 0 0 0
0 0 0 0 0 0 0 0 0 0 0
0 0 0 0 0 0 0 0 0 0 0
0 0 0 0 0 0 0 0 0 0 0
0 0 0 0 0 0 0 0 0 0 0
0 0 0 0 0 0 0 0 0 0 0