MODE 2
SIZE 11/70
LIMIT 0/29
COLOR LIMIT 5
STARS 900/2400/4500
POWERUPS 0/0/0/0
0 6 6 0 0 0 0 0 0 0 0
6 14 6 6 6 6 6 6 6 6 6
0 6 6 0 0 0 6 0 0 17 0
0 17 0 0 0 6 0 0 6 6 0
17 17 17 17 17 9 6 6 6 12 6
0 17 0 0 17 0 0 0 6 6 0
0 6 6 0 17 0 0 0 0 17 0
6 10 6 6 6 6 18 18 18 18 18
0 6 6 0 0 0 18 0 0 17 0
0 17 0 0 0 18 0 0 6 6 0
18 18 18 18 18 8 18 18 6 6 6
0 17 0 0 6 0 0 0 6 6 0
0 6 6 0 6 0 0 0 0 17 0
6 11 6 6 6 6 17 17 17 17 17
0 6 6 0 0 0 17 0 0 17 0
0 17 0 0 0 17 0 0 6 6 0
17 17 17 17 17 9 6 6 6 14 6
0 17 0 0 17 0 0 0 6 6 0
0 6 6 0 17 0 0 0 0 17 0
6 12 6 17 17 17 17 17 17 17 17
0 6 6 0 0 0 0 0 0 0 0
0 0 0 0 0 0 0 0 0 0 0
0 0 0 0 0 0 0 0 0 0 0
0 0 0 0 0 0 0 0 0 0 0
0 0 0 0 0 0 0 0 0 0 0
0 0 0 0 0 0 0 0 0 0 0
0 0 0 0 0 0 0 0 0 0 0
0 0 0 0 0 0 0 0 0 0 0
0 0 0 0 0 0 0 0 0 0 0
0 0 0 0 0 0 0 0 0 0 0
0 0 0 0 0 0 0 0 0 0 0
0 0 0 0 0 0 0 0 0 0 0
0 0 0 0 0 0 0 0 0 0 0
0 0 0 0 0 0 0 0 0 0 0
0 0 0 0 0 0 0 0 0 0 0
0 0 0 0 0 0 0 0 0 0 0
0 0 0 0 0 0 0 0 0 0 0
0 0 0 0 0 0 0 0 0 0 0
0 0 0 0 0 0 0 0 0 0 0
0 0 0 0 0 0 0 0 0 0 0
0 0 0 0 0 0 0 0 0 0 0
0 0 0 0 0 0 0 0 0 0 0
0 0 0 0 0 0 0 0 0 0 0
0 0 0 0 0 0 0 0 0 0 0
0 0 0 0 0 0 0 0 0 0 0
0 0 0 0 0 0 0 0 0 0 0
0 0 0 0 0 0 0 0 0 0 0
0 0 0 0 0 0 0 0 0 0 0
0 0 0 0 0 0 0 0 0 0 0
0 0 0 0 0 0 0 0 0 0 0
0 0 0 0 0 0 0 0 0 0 0
0 0 0 0 0 0 0 0 0 0 0
0 0 0 0 0 0 0 0 0 0 0
0 0 0 0 0 0 0 0 0 0 0
0 0 0 0 0 0 0 0 0 0 0
0 0 0 0 0 0 0 0 0 0 0
0 0 0 0 0 0 0 0 0 0 0
0 0 0 0 0 0 0 0 0 0 0
0 0 0 0 0 0 0 0 0 0 0
0 0 0 0 0 0 0 0 0 0 0
0 0 0 0 0 0 0 0 0 0 0
0 0 0 0 0 0 0 0 0 0 0
0 0 0 0 0 0 0 0 0 0 0
0 0 0 0 0 0 0 0 0 0 0
0 0 0 0 0 0 0 0 0 0 0
0 0 0 0 0 0 0 0 0 0 0
0 0 0 0 0 0 0 0 0 0 0
0 0 0 0 0 0 0 0 0 0 0
0 0 0 0 0 0 0 0 0 0 0
0 0 0 0 0 0 0 0 0 0 0