MODE 2
SIZE 11/70
LIMIT 0/25
COLOR LIMIT 5
STARS 1000/2500/5200
POWERUPS 0/0/0/0
6 6 6 6 6 6 6 6 6 6 13
6 6 11 6 6 6 6 7 6 6 9
0 0 0 0 0 0 0 0 6 6 6
0 0 0 0 0 0 0 6 6 6 0
6 6 6 6 6 6 6 6 6 6 0
9 6 6 6 6 12 6 6 6 0 0
0 6 6 6 0 0 0 0 0 0 0
0 6 6 6 0 0 0 0 0 0 0
0 0 6 6 6 6 6 6 6 6 9
0 0 13 6 6 7 6 6 6 6 6
0 0 0 0 0 0 0 0 6 6 6
0 0 0 0 0 0 0 6 6 6 0
9 6 6 6 6 6 6 6 6 6 0
6 6 6 6 6 6 6 6 14 0 0
0 6 6 6 0 0 0 0 0 0 0
0 6 6 6 0 0 0 0 0 0 0
0 0 6 6 6 6 6 6 6 6 9
0 0 6 6 6 12 6 6 6 6 6
0 0 0 0 0 0 0 0 6 6 6
0 0 0 0 0 0 0 6 6 6 0
6 6 6 6 14 6 6 6 6 9 0
6 6 6 6 6 7 6 6 13 0 0
0 6 6 6 0 0 0 0 0 0 0
0 6 6 6 0 0 0 0 0 0 0
0 0 9 6 6 6 6 6 6 6 6
0 0 6 6 6 12 6 6 6 6 6
0 0 0 0 0 0 0 0 6 6 6
0 0 0 0 0 0 0 6 6 6 0
6 6 6 6 6 6 6 6 6 6 0
6 6 6 6 6 6 11 6 9 0 0
0 6 6 6 0 0 0 0 0 0 0
0 6 6 6 0 0 0 0 0 0 0
0 0 9 6 6 7 6 6 6 6 6
0 0 13 6 6 12 6 6 6 6 6
0 0 0 0 0 0 0 0 6 6 6
0 0 0 0 0 0 0 6 6 6 0
6 6 6 6 6 14 6 6 6 9 0
6 6 6 6 6 6 6 6 6 0 0
0 6 6 6 0 0 0 0 0 0 0
0 6 6 6 0 0 0 0 0 0 0
0 0 9 6 6 6 6 6 6 6 6
0 0 6 6 6 12 6 6 6 6 6
0 0 0 0 0 0 0 0 6 8 6
0 0 0 0 0 0 0 6 6 6 0
6 6 6 6 11 6 6 6 6 6 0
6 6 6 6 7 6 6 6 6 6 0
0 0 0 0 0 0 0 0 0 0 0
0 0 0 0 0 0 0 0 0 0 0
0 0 0 0 0 0 0 0 0 0 0
0 0 0 0 0 0 0 0 0 0 0
0 0 0 0 0 0 0 0 0 0 0
0 0 0 0 0 0 0 0 0 0 0
0 0 0 0 0 0 0 0 0 0 0
0 0 0 0 0 0 0 0 0 0 0
0 0 0 0 0 0 0 0 0 0 0
0 0 0 0 0 0 0 0 0 0 0
0 0 0 0 0 0 0 0 0 0 0
0 0 0 0 0 0 0 0 0 0 0
0 0 0 0 0 0 0 0 0 0 0
0 0 0 0 0 0 0 0 0 0 0
0 0 0 0 0 0 0 0 0 0 0
0 0 0 0 0 0 0 0 0 0 0
0 0 0 0 0 0 0 0 0 0 0
0 0 0 0 0 0 0 0 0 0 0
0 0 0 0 0 0 0 0 0 0 0
0 0 0 0 0 0 0 0 0 0 0
0 0 0 0 0 0 0 0 0 0 0
0 0 0 0 0 0 0 0 0 0 0
0 0 0 0 0 0 0 0 0 0 0
0 0 0 0 0 0 0 0 0 0 0