MODE 2
SIZE 11/70
LIMIT 0/23
COLOR LIMIT 5
STARS 1000/3500/5000
POWERUPS 0/0/0/0
18 18 18 0 2 2 2 0 18 18 18
4 4 4 2 18 18 2 4 4 4 0
18 18 18 0 2 11 2 0 18 18 18
17 17 17 0 2 2 0 0 17 17 17
18 18 18 0 1 7 1 0 18 18 18
4 4 4 1 18 18 1 4 4 4 0
18 18 18 0 1 10 1 0 18 18 18
16 16 16 0 1 1 0 0 17 17 17
18 18 18 0 5 8 5 0 18 18 18
4 4 4 5 18 18 5 4 4 4 0
18 18 18 0 5 14 5 0 18 18 18
17 17 17 0 5 5 0 0 16 16 16
18 18 18 0 3 7 3 0 18 18 18
4 4 4 3 18 18 3 4 4 4 0
18 18 18 0 3 8 3 0 18 18 18
16 16 16 0 3 3 0 0 17 17 17
18 18 18 0 2 8 2 0 18 18 18
4 4 4 2 18 18 2 4 4 4 0
18 18 18 0 2 11 2 0 18 18 18
17 17 17 0 2 2 0 0 16 16 16
18 18 18 0 1 7 1 0 18 18 18
4 4 4 1 18 18 1 4 4 4 0
18 18 18 0 1 10 1 0 18 18 18
16 16 16 0 1 1 0 0 17 17 17
0 0 0 0 0 0 0 0 0 0 0
0 0 0 0 0 0 0 0 0 0 0
0 0 0 0 0 0 0 0 0 0 0
0 0 0 0 0 0 0 0 0 0 0
0 0 0 0 0 0 0 0 0 0 0
0 0 0 0 0 0 0 0 0 0 0
0 0 0 0 0 0 0 0 0 0 0
0 0 0 0 0 0 0 0 0 0 0
0 0 0 0 0 0 0 0 0 0 0
0 0 0 0 0 0 0 0 0 0 0
0 0 0 0 0 0 0 0 0 0 0
0 0 0 0 0 0 0 0 0 0 0
0 0 0 0 0 0 0 0 0 0 0
0 0 0 0 0 0 0 0 0 0 0
0 0 0 0 0 0 0 0 0 0 0
0 0 0 0 0 0 0 0 0 0 0
0 0 0 0 0 0 0 0 0 0 0
0 0 0 0 0 0 0 0 0 0 0
0 0 0 0 0 0 0 0 0 0 0
0 0 0 0 0 0 0 0 0 0 0
0 0 0 0 0 0 0 0 0 0 0
0 0 0 0 0 0 0 0 0 0 0
0 0 0 0 0 0 0 0 0 0 0
0 0 0 0 0 0 0 0 0 0 0
0 0 0 0 0 0 0 0 0 0 0
0 0 0 0 0 0 0 0 0 0 0
0 0 0 0 0 0 0 0 0 0 0
0 0 0 0 0 0 0 0 0 0 0
0 0 0 0 0 0 0 0 0 0 0
0 0 0 0 0 0 0 0 0 0 0
0 0 0 0 0 0 0 0 0 0 0
0 0 0 0 0 0 0 0 0 0 0
0 0 0 0 0 0 0 0 0 0 0
0 0 0 0 0 0 0 0 0 0 0
0 0 0 0 0 0 0 0 0 0 0
0 0 0 0 0 0 0 0 0 0 0
0 0 0 0 0 0 0 0 0 0 0
0 0 0 0 0 0 0 0 0 0 0
0 0 0 0 0 0 0 0 0 0 0
0 0 0 0 0 0 0 0 0 0 0
0 0 0 0 0 0 0 0 0 0 0
0 0 0 0 0 0 0 0 0 0 0
0 0 0 0 0 0 0 0 0 0 0
0 0 0 0 0 0 0 0 0 0 0
0 0 0 0 0 0 0 0 0 0 0
0 0 0 0 0 0 0 0 0 0 0