MODE 2
SIZE 11/70
LIMIT 0/27
COLOR LIMIT 5
STARS 900/2100/4000
POWERUPS 0/0/0/0
0 6 6 0 0 10 0 0 0 0 0
9 14 6 6 17 17 17 17 6 6 6
0 6 6 0 0 0 17 17 0 17 0
0 17 0 0 0 17 0 0 6 6 0
9 6 6 17 17 9 17 17 6 12 6
0 17 0 0 17 0 0 0 6 6 0
0 6 6 0 17 0 0 0 0 17 0
6 10 6 17 17 17 17 17 6 6 9
0 6 6 0 0 0 17 0 0 17 0
0 17 0 0 0 17 0 0 6 6 0
9 6 6 17 17 8 17 17 6 7 6
0 17 0 0 17 0 0 0 6 6 0
0 6 6 0 17 17 0 0 0 17 0
6 11 6 17 17 17 17 17 6 6 6
0 6 6 0 0 0 17 17 0 17 0
0 17 0 0 0 17 0 0 6 6 0
6 6 6 17 17 9 17 17 6 14 9
0 17 0 0 17 0 0 0 6 6 0
0 6 6 0 17 0 0 0 0 17 0
6 12 6 17 17 17 6 6 6 6 7
0 6 6 0 0 0 0 0 0 0 0
0 0 0 0 0 0 0 0 0 0 0
0 0 0 0 0 0 0 0 0 0 0
0 0 0 0 0 0 0 0 0 0 0
0 0 0 0 0 0 0 0 0 0 0
0 0 0 0 0 0 0 0 0 0 0
0 0 0 0 0 0 0 0 0 0 0
0 0 0 0 0 0 0 0 0 0 0
0 0 0 0 0 0 0 0 0 0 0
0 0 0 0 0 0 0 0 0 0 0
0 0 0 0 0 0 0 0 0 0 0
0 0 0 0 0 0 0 0 0 0 0
0 0 0 0 0 0 0 0 0 0 0
0 0 0 0 0 0 0 0 0 0 0
0 0 0 0 0 0 0 0 0 0 0
0 0 0 0 0 0 0 0 0 0 0
0 0 0 0 0 0 0 0 0 0 0
0 0 0 0 0 0 0 0 0 0 0
0 0 0 0 0 0 0 0 0 0 0
0 0 0 0 0 0 0 0 0 0 0
0 0 0 0 0 0 0 0 0 0 0
0 0 0 0 0 0 0 0 0 0 0
0 0 0 0 0 0 0 0 0 0 0
0 0 0 0 0 0 0 0 0 0 0
0 0 0 0 0 0 0 0 0 0 0
0 0 0 0 0 0 0 0 0 0 0
0 0 0 0 0 0 0 0 0 0 0
0 0 0 0 0 0 0 0 0 0 0
0 0 0 0 0 0 0 0 0 0 0
0 0 0 0 0 0 0 0 0 0 0
0 0 0 0 0 0 0 0 0 0 0
0 0 0 0 0 0 0 0 0 0 0
0 0 0 0 0 0 0 0 0 0 0
0 0 0 0 0 0 0 0 0 0 0
0 0 0 0 0 0 0 0 0 0 0
0 0 0 0 0 0 0 0 0 0 0
0 0 0 0 0 0 0 0 0 0 0
0 0 0 0 0 0 0 0 0 0 0
0 0 0 0 0 0 0 0 0 0 0
0 0 0 0 0 0 0 0 0 0 0
0 0 0 0 0 0 0 0 0 0 0
0 0 0 0 0 0 0 0 0 0 0
0 0 0 0 0 0 0 0 0 0 0
0 0 0 0 0 0 0 0 0 0 0
0 0 0 0 0 0 0 0 0 0 0
0 0 0 0 0 0 0 0 0 0 0
0 0 0 0 0 0 0 0 0 0 0
0 0 0 0 0 0 0 0 0 0 0
0 0 0 0 0 0 0 0 0 0 0
0 0 0 0 0 0 0 0 0 0 0