MODE 2
SIZE 11/70
LIMIT 0/25
COLOR LIMIT 5
STARS 500/2100/5300
POWERUPS 0/0/0/0
6 6 6 6 6 6 6 6 6 6 6
6 6 0 0 6 6 0 0 0 6 6
6 6 0 0 0 6 6 0 0 6 11
6 14 0 0 6 9 0 0 0 6 6
6 6 6 6 6 6 6 6 6 6 6
12 6 0 0 6 6 0 0 0 6 6
6 6 0 0 0 6 6 0 0 6 6
7 6 6 6 6 6 6 6 6 6 6
6 6 0 0 6 11 0 0 0 12 6
6 6 0 0 6 6 0 0 0 6 7
6 6 0 0 0 8 6 0 0 14 6
7 6 6 6 6 6 6 6 6 6 6
6 6 0 0 0 6 6 0 0 6 6
6 6 0 0 6 6 0 0 0 6 6
6 11 0 0 6 12 0 0 0 6 6
6 6 0 0 6 6 0 0 6 6 0
0 17 17 17 6 9 6 17 17 17 0
0 6 6 0 6 6 0 6 6 0 0
0 0 6 6 0 6 0 6 6 0 0
0 0 6 6 6 12 6 6 0 0 0
0 0 0 0 0 0 0 0 0 0 0
0 0 0 0 0 0 0 0 0 0 0
0 0 0 0 0 0 0 0 0 0 0
0 0 0 0 0 0 0 0 0 0 0
0 0 0 0 0 0 0 0 0 0 0
0 0 0 0 0 0 0 0 0 0 0
0 0 0 0 0 0 0 0 0 0 0
0 0 0 0 0 0 0 0 0 0 0
0 0 0 0 0 0 0 0 0 0 0
0 0 0 0 0 0 0 0 0 0 0
0 0 0 0 0 0 0 0 0 0 0
0 0 0 0 0 0 0 0 0 0 0
0 0 0 0 0 0 0 0 0 0 0
0 0 0 0 0 0 0 0 0 0 0
0 0 0 0 0 0 0 0 0 0 0
0 0 0 0 0 0 0 0 0 0 0
0 0 0 0 0 0 0 0 0 0 0
0 0 0 0 0 0 0 0 0 0 0
0 0 0 0 0 0 0 0 0 0 0
0 0 0 0 0 0 0 0 0 0 0
0 0 0 0 0 0 0 0 0 0 0
0 0 0 0 0 0 0 0 0 0 0
0 0 0 0 0 0 0 0 0 0 0
0 0 0 0 0 0 0 0 0 0 0
0 0 0 0 0 0 0 0 0 0 0
0 0 0 0 0 0 0 0 0 0 0
0 0 0 0 0 0 0 0 0 0 0
0 0 0 0 0 0 0 0 0 0 0
0 0 0 0 0 0 0 0 0 0 0
0 0 0 0 0 0 0 0 0 0 0
0 0 0 0 0 0 0 0 0 0 0
0 0 0 0 0 0 0 0 0 0 0
0 0 0 0 0 0 0 0 0 0 0
0 0 0 0 0 0 0 0 0 0 0
0 0 0 0 0 0 0 0 0 0 0
0 0 0 0 0 0 0 0 0 0 0
0 0 0 0 0 0 0 0 0 0 0
0 0 0 0 0 0 0 0 0 0 0
0 0 0 0 0 0 0 0 0 0 0
0 0 0 0 0 0 0 0 0 0 0
0 0 0 0 0 0 0 0 0 0 0
0 0 0 0 0 0 0 0 0 0 0
0 0 0 0 0 0 0 0 0 0 0
0 0 0 0 0 0 0 0 0 0 0
0 0 0 0 0 0 0 0 0 0 0
0 0 0 0 0 0 0 0 0 0 0
0 0 0 0 0 0 0 0 0 0 0
0 0 0 0 0 0 0 0 0 0 0
0 0 0 0 0 0 0 0 0 0 0
0 0 0 0 0 0 0 0 0 0 0