MODE 2
SIZE 11/70
LIMIT 0/21
COLOR LIMIT 4
STARS 900/4100/5850
POWERUPS 0/0/0/0
6 6 6 6 6 6 6 6 6 6 6
6 6 6 6 14 6 6 6 6 6 0
0 6 6 0 0 0 0 0 6 6 0
0 6 6 0 0 0 0 6 6 0 0
0 0 6 11 0 0 0 6 6 0 0
0 0 6 6 0 0 6 6 0 0 0
0 0 0 6 6 0 6 6 0 0 0
0 0 0 6 6 6 11 0 0 0 0
0 0 0 0 6 8 6 0 0 0 0
0 0 0 0 6 6 0 0 0 0 0
0 0 0 0 6 14 6 0 0 0 0
0 0 0 6 6 6 6 0 0 0 0
0 0 0 6 6 0 6 6 0 0 0
0 0 6 6 0 0 6 6 0 0 0
0 0 12 6 0 0 0 6 12 0 0
0 6 6 0 0 0 0 6 6 0 0
0 6 6 0 0 0 0 0 6 6 0
9 6 6 6 6 6 6 6 6 6 0
13 6 8 6 6 14 6 6 8 6 13
6 6 6 6 6 6 6 6 6 9 0
0 6 6 0 0 0 0 0 6 6 0
0 6 6 0 0 0 0 6 6 0 0
0 0 6 6 0 0 0 6 6 0 0
0 0 6 6 0 0 6 6 0 0 0
0 0 0 6 6 0 6 6 0 0 0
0 0 0 6 6 6 6 0 0 0 0
0 0 0 0 6 8 6 0 0 0 0
6 6 6 6 6 6 6 6 6 6 0
6 6 6 6 6 7 6 6 6 6 6
0 0 0 0 0 0 0 0 0 0 0
0 0 0 0 0 0 0 0 0 0 0
0 0 0 0 0 0 0 0 0 0 0
0 0 0 0 0 0 0 0 0 0 0
0 0 0 0 0 0 0 0 0 0 0
0 0 0 0 0 0 0 0 0 0 0
0 0 0 0 0 0 0 0 0 0 0
0 0 0 0 0 0 0 0 0 0 0
0 0 0 0 0 0 0 0 0 0 0
0 0 0 0 0 0 0 0 0 0 0
0 0 0 0 0 0 0 0 0 0 0
0 0 0 0 0 0 0 0 0 0 0
0 0 0 0 0 0 0 0 0 0 0
0 0 0 0 0 0 0 0 0 0 0
0 0 0 0 0 0 0 0 0 0 0
0 0 0 0 0 0 0 0 0 0 0
0 0 0 0 0 0 0 0 0 0 0
0 0 0 0 0 0 0 0 0 0 0
0 0 0 0 0 0 0 0 0 0 0
0 0 0 0 0 0 0 0 0 0 0
0 0 0 0 0 0 0 0 0 0 0
0 0 0 0 0 0 0 0 0 0 0
0 0 0 0 0 0 0 0 0 0 0
0 0 0 0 0 0 0 0 0 0 0
0 0 0 0 0 0 0 0 0 0 0
0 0 0 0 0 0 0 0 0 0 0
0 0 0 0 0 0 0 0 0 0 0
0 0 0 0 0 0 0 0 0 0 0
0 0 0 0 0 0 0 0 0 0 0
0 0 0 0 0 0 0 0 0 0 0
0 0 0 0 0 0 0 0 0 0 0
0 0 0 0 0 0 0 0 0 0 0
0 0 0 0 0 0 0 0 0 0 0
0 0 0 0 0 0 0 0 0 0 0
0 0 0 0 0 0 0 0 0 0 0
0 0 0 0 0 0 0 0 0 0 0
0 0 0 0 0 0 0 0 0 0 0
0 0 0 0 0 0 0 0 0 0 0
0 0 0 0 0 0 0 0 0 0 0
0 0 0 0 0 0 0 0 0 0 0
0 0 0 0 0 0 0 0 0 0 0