MODE 2
SIZE 11/70
LIMIT 0/18
COLOR LIMIT 5
STARS 500/1200/3100
POWERUPS 0/0/0/0
6 6 6 6 6 6 6 6 6 6 6
0 6 0 0 6 6 0 0 6 0 0
0 0 6 0 0 6 0 0 0 6 0
0 9 0 0 6 6 0 0 9 0 0
0 1 1 0 0 2 0 0 5 5 0
1 10 1 17 2 2 17 5 14 5 0
0 1 1 0 0 2 0 0 5 5 0
0 6 0 0 6 6 0 0 6 0 0
0 0 6 0 0 6 0 0 6 0 0
0 6 0 0 6 6 0 0 6 0 0
0 0 6 0 0 9 0 0 6 0 0
0 2 2 0 5 5 0 1 1 0 0
0 2 11 2 17 5 17 1 10 1 0
0 2 2 0 5 5 0 1 1 0 0
0 0 6 0 0 6 0 0 6 0 0
0 6 0 0 6 6 0 0 6 0 0
0 0 6 0 0 6 0 0 6 0 0
0 9 0 0 6 6 0 0 9 0 0
0 5 5 0 0 1 0 0 2 2 0
5 14 5 17 1 1 17 2 11 2 0
0 5 5 0 0 1 0 0 2 2 0
0 0 0 0 0 0 0 0 0 0 0
0 0 0 0 0 0 0 0 0 0 0
0 0 0 0 0 0 0 0 0 0 0
0 0 0 0 0 0 0 0 0 0 0
0 0 0 0 0 0 0 0 0 0 0
0 0 0 0 0 0 0 0 0 0 0
0 0 0 0 0 0 0 0 0 0 0
0 0 0 0 0 0 0 0 0 0 0
0 0 0 0 0 0 0 0 0 0 0
0 0 0 0 0 0 0 0 0 0 0
0 0 0 0 0 0 0 0 0 0 0
0 0 0 0 0 0 0 0 0 0 0
0 0 0 0 0 0 0 0 0 0 0
0 0 0 0 0 0 0 0 0 0 0
0 0 0 0 0 0 0 0 0 0 0
0 0 0 0 0 0 0 0 0 0 0
0 0 0 0 0 0 0 0 0 0 0
0 0 0 0 0 0 0 0 0 0 0
0 0 0 0 0 0 0 0 0 0 0
0 0 0 0 0 0 0 0 0 0 0
0 0 0 0 0 0 0 0 0 0 0
0 0 0 0 0 0 0 0 0 0 0
0 0 0 0 0 0 0 0 0 0 0
0 0 0 0 0 0 0 0 0 0 0
0 0 0 0 0 0 0 0 0 0 0
0 0 0 0 0 0 0 0 0 0 0
0 0 0 0 0 0 0 0 0 0 0
0 0 0 0 0 0 0 0 0 0 0
0 0 0 0 0 0 0 0 0 0 0
0 0 0 0 0 0 0 0 0 0 0
0 0 0 0 0 0 0 0 0 0 0
0 0 0 0 0 0 0 0 0 0 0
0 0 0 0 0 0 0 0 0 0 0
0 0 0 0 0 0 0 0 0 0 0
0 0 0 0 0 0 0 0 0 0 0
0 0 0 0 0 0 0 0 0 0 0
0 0 0 0 0 0 0 0 0 0 0
0 0 0 0 0 0 0 0 0 0 0
0 0 0 0 0 0 0 0 0 0 0
0 0 0 0 0 0 0 0 0 0 0
0 0 0 0 0 0 0 0 0 0 0
0 0 0 0 0 0 0 0 0 0 0
0 0 0 0 0 0 0 0 0 0 0
0 0 0 0 0 0 0 0 0 0 0
0 0 0 0 0 0 0 0 0 0 0
0 0 0 0 0 0 0 0 0 0 0
0 0 0 0 0 0 0 0 0 0 0
0 0 0 0 0 0 0 0 0 0 0
0 0 0 0 0 0 0 0 0 0 0