MODE 2
SIZE 11/70
LIMIT 0/17
COLOR LIMIT 5
STARS 500/2300/4700
POWERUPS 0/0/0/0
0 6 6 0 0 6 6 0 0 6 6
6 14 6 0 6 10 6 0 6 12 6
0 6 6 0 0 17 17 0 0 6 6
0 17 17 6 0 0 0 6 17 17 0
0 0 0 6 6 0 0 6 6 0 0
0 0 0 6 0 0 0 6 0 0 0
0 6 6 17 17 6 6 17 17 6 6
6 11 6 0 6 10 6 0 6 8 6
0 6 6 0 0 6 6 0 0 6 6
0 17 17 6 0 0 0 6 17 17 0
0 0 0 6 6 0 0 6 6 0 0
0 0 0 6 0 0 0 6 0 0 0
0 6 6 7 17 6 6 7 17 6 6
6 6 6 0 6 12 6 0 6 13 6
0 6 6 0 0 6 6 0 0 6 6
0 17 7 6 0 0 0 6 7 17 0
0 0 0 6 6 0 0 6 6 0 0
0 0 0 6 0 0 0 6 0 0 0
0 6 6 17 17 6 6 17 17 6 6
6 13 6 0 6 11 6 0 6 8 6
0 6 6 0 0 6 6 0 0 6 6
0 7 17 0 0 0 0 0 17 7 0
0 0 0 0 0 0 0 0 0 0 0
0 0 0 0 0 0 0 0 0 0 0
0 0 0 0 0 0 0 0 0 0 0
0 0 0 0 0 0 0 0 0 0 0
0 0 0 0 0 0 0 0 0 0 0
0 0 0 0 0 0 0 0 0 0 0
0 0 0 0 0 0 0 0 0 0 0
0 0 0 0 0 0 0 0 0 0 0
0 0 0 0 0 0 0 0 0 0 0
0 0 0 0 0 0 0 0 0 0 0
0 0 0 0 0 0 0 0 0 0 0
0 0 0 0 0 0 0 0 0 0 0
0 0 0 0 0 0 0 0 0 0 0
0 0 0 0 0 0 0 0 0 0 0
0 0 0 0 0 0 0 0 0 0 0
0 0 0 0 0 0 0 0 0 0 0
0 0 0 0 0 0 0 0 0 0 0
0 0 0 0 0 0 0 0 0 0 0
0 0 0 0 0 0 0 0 0 0 0
0 0 0 0 0 0 0 0 0 0 0
0 0 0 0 0 0 0 0 0 0 0
0 0 0 0 0 0 0 0 0 0 0
0 0 0 0 0 0 0 0 0 0 0
0 0 0 0 0 0 0 0 0 0 0
0 0 0 0 0 0 0 0 0 0 0
0 0 0 0 0 0 0 0 0 0 0
0 0 0 0 0 0 0 0 0 0 0
0 0 0 0 0 0 0 0 0 0 0
0 0 0 0 0 0 0 0 0 0 0
0 0 0 0 0 0 0 0 0 0 0
0 0 0 0 0 0 0 0 0 0 0
0 0 0 0 0 0 0 0 0 0 0
0 0 0 0 0 0 0 0 0 0 0
0 0 0 0 0 0 0 0 0 0 0
0 0 0 0 0 0 0 0 0 0 0
0 0 0 0 0 0 0 0 0 0 0
0 0 0 0 0 0 0 0 0 0 0
0 0 0 0 0 0 0 0 0 0 0
0 0 0 0 0 0 0 0 0 0 0
0 0 0 0 0 0 0 0 0 0 0
0 0 0 0 0 0 0 0 0 0 0
0 0 0 0 0 0 0 0 0 0 0
0 0 0 0 0 0 0 0 0 0 0
0 0 0 0 0 0 0 0 0 0 0
0 0 0 0 0 0 0 0 0 0 0
0 0 0 0 0 0 0 0 0 0 0
0 0 0 0 0 0 0 0 0 0 0
0 0 0 0 0 0 0 0 0 0 0