MODE 2
SIZE 11/70
LIMIT 0/12
COLOR LIMIT 3
STARS 1000/3200/6500
POWERUPS 0/0/0/0
6 6 6 6 5 5 5 6 6 6 6
4 4 4 13 5 5 6 3 3 3 0
4 4 4 4 16 15 16 3 3 3 3
6 6 6 5 5 5 5 5 6 6 6
0 0 0 0 3 5 3 0 0 0 0
0 0 0 0 3 3 0 0 0 0 0
0 0 0 0 3 5 3 0 0 0 0
0 0 0 0 3 3 0 0 0 0 0
0 0 0 0 3 5 3 0 0 0 0
0 0 0 3 6 6 3 0 0 0 0
0 0 0 0 3 8 3 0 0 0 0
0 0 0 3 6 6 3 0 0 0 0
0 0 0 0 3 5 3 0 0 0 0
0 0 0 3 6 6 3 0 0 0 0
0 0 0 0 3 5 3 0 0 0 0
0 0 5 5 6 6 5 5 0 0 0
0 0 0 5 4 14 4 5 0 0 0
0 0 0 5 4 4 5 0 0 0 0
0 0 0 0 6 6 6 0 0 0 0
0 0 5 5 6 6 5 5 0 0 0
0 0 0 5 4 14 4 5 0 0 0
0 0 0 5 4 4 5 0 0 0 0
0 0 0 0 6 6 6 0 0 0 0
0 0 0 0 0 0 0 0 0 0 0
0 0 0 0 0 0 0 0 0 0 0
0 0 0 0 0 0 0 0 0 0 0
0 0 0 0 0 0 0 0 0 0 0
0 0 0 0 0 0 0 0 0 0 0
0 0 0 0 0 0 0 0 0 0 0
0 0 0 0 0 0 0 0 0 0 0
0 0 0 0 0 0 0 0 0 0 0
0 0 0 0 0 0 0 0 0 0 0
0 0 0 0 0 0 0 0 0 0 0
0 0 0 0 0 0 0 0 0 0 0
0 0 0 0 0 0 0 0 0 0 0
0 0 0 0 0 0 0 0 0 0 0
0 0 0 0 0 0 0 0 0 0 0
0 0 0 0 0 0 0 0 0 0 0
0 0 0 0 0 0 0 0 0 0 0
0 0 0 0 0 0 0 0 0 0 0
0 0 0 0 0 0 0 0 0 0 0
0 0 0 0 0 0 0 0 0 0 0
0 0 0 0 0 0 0 0 0 0 0
0 0 0 0 0 0 0 0 0 0 0
0 0 0 0 0 0 0 0 0 0 0
0 0 0 0 0 0 0 0 0 0 0
0 0 0 0 0 0 0 0 0 0 0
0 0 0 0 0 0 0 0 0 0 0
0 0 0 0 0 0 0 0 0 0 0
0 0 0 0 0 0 0 0 0 0 0
0 0 0 0 0 0 0 0 0 0 0
0 0 0 0 0 0 0 0 0 0 0
0 0 0 0 0 0 0 0 0 0 0
0 0 0 0 0 0 0 0 0 0 0
0 0 0 0 0 0 0 0 0 0 0
0 0 0 0 0 0 0 0 0 0 0
0 0 0 0 0 0 0 0 0 0 0
0 0 0 0 0 0 0 0 0 0 0
0 0 0 0 0 0 0 0 0 0 0
0 0 0 0 0 0 0 0 0 0 0
0 0 0 0 0 0 0 0 0 0 0
0 0 0 0 0 0 0 0 0 0 0
0 0 0 0 0 0 0 0 0 0 0
0 0 0 0 0 0 0 0 0 0 0
0 0 0 0 0 0 0 0 0 0 0
0 0 0 0 0 0 0 0 0 0 0
0 0 0 0 0 0 0 0 0 0 0
0 0 0 0 0 0 0 0 0 0 0
0 0 0 0 0 0 0 0 0 0 0
0 0 0 0 0 0 0 0 0 0 0