MODE 2
SIZE 11/70
LIMIT 0/25
COLOR LIMIT 5
STARS 1000/3000/6800
POWERUPS 0/0/0/0
0 0 6 6 0 0 0 0 0 0 0
6 6 14 6 6 8 0 0 0 0 0
0 17 6 6 17 6 6 0 6 6 0
0 17 17 17 0 0 18 10 6 6 6
0 0 6 6 0 0 18 17 6 14 17
6 6 6 6 6 8 0 17 17 17 0
0 17 6 6 17 6 6 0 6 12 0
0 17 17 17 0 0 18 6 6 6 6
0 0 6 6 0 0 18 17 6 6 17
6 6 6 10 6 8 0 17 17 17 0
0 0 6 6 0 6 6 0 6 6 0
0 0 0 0 0 0 0 6 6 6 6
0 0 6 6 0 0 0 0 6 6 0
6 6 11 6 6 8 0 0 0 0 0
0 17 6 6 17 6 6 0 13 6 0
0 17 17 17 0 0 18 6 6 6 12
0 0 6 6 0 0 18 17 6 6 17
6 6 6 6 6 8 0 17 17 17 0
0 17 12 6 17 6 6 0 6 11 0
0 17 17 17 6 6 18 10 6 6 6
0 0 6 6 6 6 6 0 6 6 0
13 6 6 6 6 8 0 0 0 0 0
0 0 0 6 6 6 6 6 6 6 0
0 0 0 0 0 0 18 6 6 6 6
0 0 6 6 0 0 18 0 6 14 6
6 6 11 6 6 8 0 0 0 0 0
0 0 6 6 0 0 0 0 0 0 0
0 0 0 0 0 0 0 0 0 0 0
0 0 0 0 0 0 0 0 0 0 0
0 0 0 0 0 0 0 0 0 0 0
0 0 0 0 0 0 0 0 0 0 0
0 0 0 0 0 0 0 0 0 0 0
0 0 0 0 0 0 0 0 0 0 0
0 0 0 0 0 0 0 0 0 0 0
0 0 0 0 0 0 0 0 0 0 0
0 0 0 0 0 0 0 0 0 0 0
0 0 0 0 0 0 0 0 0 0 0
0 0 0 0 0 0 0 0 0 0 0
0 0 0 0 0 0 0 0 0 0 0
0 0 0 0 0 0 0 0 0 0 0
0 0 0 0 0 0 0 0 0 0 0
0 0 0 0 0 0 0 0 0 0 0
0 0 0 0 0 0 0 0 0 0 0
0 0 0 0 0 0 0 0 0 0 0
0 0 0 0 0 0 0 0 0 0 0
0 0 0 0 0 0 0 0 0 0 0
0 0 0 0 0 0 0 0 0 0 0
0 0 0 0 0 0 0 0 0 0 0
0 0 0 0 0 0 0 0 0 0 0
0 0 0 0 0 0 0 0 0 0 0
0 0 0 0 0 0 0 0 0 0 0
0 0 0 0 0 0 0 0 0 0 0
0 0 0 0 0 0 0 0 0 0 0
0 0 0 0 0 0 0 0 0 0 0
0 0 0 0 0 0 0 0 0 0 0
0 0 0 0 0 0 0 0 0 0 0
0 0 0 0 0 0 0 0 0 0 0
0 0 0 0 0 0 0 0 0 0 0
0 0 0 0 0 0 0 0 0 0 0
0 0 0 0 0 0 0 0 0 0 0
0 0 0 0 0 0 0 0 0 0 0
0 0 0 0 0 0 0 0 0 0 0
0 0 0 0 0 0 0 0 0 0 0
0 0 0 0 0 0 0 0 0 0 0
0 0 0 0 0 0 0 0 0 0 0
0 0 0 0 0 0 0 0 0 0 0
0 0 0 0 0 0 0 0 0 0 0
0 0 0 0 0 0 0 0 0 0 0
0 0 0 0 0 0 0 0 0 0 0
0 0 0 0 0 0 0 0 0 0 0