MODE 2
SIZE 11/70
LIMIT 0/23
COLOR LIMIT 5
STARS 900/4300/6800
POWERUPS 0/0/0/0
5 5 5 0 2 7 2 0 5 5 5
4 4 4 2 18 18 2 4 4 4 0
3 3 3 0 2 11 2 0 3 3 3
17 17 7 0 2 2 0 0 7 17 17
1 1 1 0 1 18 1 0 1 1 1
4 4 4 1 18 18 1 4 4 4 0
2 2 2 0 1 12 1 0 2 2 2
17 17 17 0 1 1 0 0 17 17 17
5 5 5 0 5 7 5 0 5 5 5
4 4 4 5 18 18 5 4 4 4 0
5 5 5 0 5 14 5 0 5 5 5
17 17 8 0 5 5 0 0 8 17 17
3 3 3 0 3 18 3 0 3 3 3
4 4 4 3 18 18 3 4 4 4 0
3 3 3 0 3 12 3 0 3 3 3
8 17 17 0 3 3 0 0 17 17 8
1 1 1 0 2 7 2 0 1 1 1
4 4 4 2 18 18 2 4 4 4 0
1 1 1 0 2 11 2 0 1 1 1
8 17 17 0 2 2 0 0 17 17 8
2 2 2 0 1 18 1 0 2 2 2
4 4 4 1 18 18 1 4 4 4 0
2 2 2 0 1 10 1 0 2 2 2
8 17 17 0 1 1 0 0 17 17 8
0 0 0 0 0 0 0 0 0 0 0
0 0 0 0 0 0 0 0 0 0 0
0 0 0 0 0 0 0 0 0 0 0
0 0 0 0 0 0 0 0 0 0 0
0 0 0 0 0 0 0 0 0 0 0
0 0 0 0 0 0 0 0 0 0 0
0 0 0 0 0 0 0 0 0 0 0
0 0 0 0 0 0 0 0 0 0 0
0 0 0 0 0 0 0 0 0 0 0
0 0 0 0 0 0 0 0 0 0 0
0 0 0 0 0 0 0 0 0 0 0
0 0 0 0 0 0 0 0 0 0 0
0 0 0 0 0 0 0 0 0 0 0
0 0 0 0 0 0 0 0 0 0 0
0 0 0 0 0 0 0 0 0 0 0
0 0 0 0 0 0 0 0 0 0 0
0 0 0 0 0 0 0 0 0 0 0
0 0 0 0 0 0 0 0 0 0 0
0 0 0 0 0 0 0 0 0 0 0
0 0 0 0 0 0 0 0 0 0 0
0 0 0 0 0 0 0 0 0 0 0
0 0 0 0 0 0 0 0 0 0 0
0 0 0 0 0 0 0 0 0 0 0
0 0 0 0 0 0 0 0 0 0 0
0 0 0 0 0 0 0 0 0 0 0
0 0 0 0 0 0 0 0 0 0 0
0 0 0 0 0 0 0 0 0 0 0
0 0 0 0 0 0 0 0 0 0 0
0 0 0 0 0 0 0 0 0 0 0
0 0 0 0 0 0 0 0 0 0 0
0 0 0 0 0 0 0 0 0 0 0
0 0 0 0 0 0 0 0 0 0 0
0 0 0 0 0 0 0 0 0 0 0
0 0 0 0 0 0 0 0 0 0 0
0 0 0 0 0 0 0 0 0 0 0
0 0 0 0 0 0 0 0 0 0 0
0 0 0 0 0 0 0 0 0 0 0
0 0 0 0 0 0 0 0 0 0 0
0 0 0 0 0 0 0 0 0 0 0
0 0 0 0 0 0 0 0 0 0 0
0 0 0 0 0 0 0 0 0 0 0
0 0 0 0 0 0 0 0 0 0 0
0 0 0 0 0 0 0 0 0 0 0
0 0 0 0 0 0 0 0 0 0 0
0 0 0 0 0 0 0 0 0 0 0
0 0 0 0 0 0 0 0 0 0 0