MODE 2
SIZE 11/70
LIMIT 0/21
COLOR LIMIT 4
STARS 1000/3000/7400
POWERUPS 0/0/0/0
6 6 6 6 6 0 6 6 6 6 6
5 5 6 6 6 6 6 6 2 2 0
5 14 5 6 6 18 6 6 2 11 2
5 5 0 0 18 18 0 0 2 2 0
0 0 0 0 0 18 0 0 0 0 0
10 6 6 6 6 6 6 6 6 6 7
0 2 2 0 0 18 0 0 1 1 0
2 11 2 0 18 18 0 1 10 1 0
0 2 2 0 0 18 0 0 1 1 0
6 6 6 6 6 6 6 6 6 6 10
0 1 1 6 6 6 6 6 5 5 0
1 10 1 0 7 6 0 5 14 5 0
0 1 1 0 0 18 0 0 5 5 0
0 0 0 0 18 18 0 0 0 0 0
0 0 0 0 0 18 0 0 0 0 0
6 6 6 6 6 6 6 6 6 6 6
0 2 2 0 0 10 0 0 1 1 0
2 11 2 0 6 7 0 1 10 1 0
0 2 2 0 0 6 0 0 1 1 0
6 6 6 6 6 6 6 6 6 6 6
17 17 17 17 17 6 17 17 17 17 17
1 1 1 1 6 6 1 1 1 1 1
1 1 1 1 1 7 1 1 1 1 1
0 0 0 0 0 0 0 0 0 0 0
0 0 0 0 0 0 0 0 0 0 0
0 0 0 0 0 0 0 0 0 0 0
0 0 0 0 0 0 0 0 0 0 0
0 0 0 0 0 0 0 0 0 0 0
0 0 0 0 0 0 0 0 0 0 0
0 0 0 0 0 0 0 0 0 0 0
0 0 0 0 0 0 0 0 0 0 0
0 0 0 0 0 0 0 0 0 0 0
0 0 0 0 0 0 0 0 0 0 0
0 0 0 0 0 0 0 0 0 0 0
0 0 0 0 0 0 0 0 0 0 0
0 0 0 0 0 0 0 0 0 0 0
0 0 0 0 0 0 0 0 0 0 0
0 0 0 0 0 0 0 0 0 0 0
0 0 0 0 0 0 0 0 0 0 0
0 0 0 0 0 0 0 0 0 0 0
0 0 0 0 0 0 0 0 0 0 0
0 0 0 0 0 0 0 0 0 0 0
0 0 0 0 0 0 0 0 0 0 0
0 0 0 0 0 0 0 0 0 0 0
0 0 0 0 0 0 0 0 0 0 0
0 0 0 0 0 0 0 0 0 0 0
0 0 0 0 0 0 0 0 0 0 0
0 0 0 0 0 0 0 0 0 0 0
0 0 0 0 0 0 0 0 0 0 0
0 0 0 0 0 0 0 0 0 0 0
0 0 0 0 0 0 0 0 0 0 0
0 0 0 0 0 0 0 0 0 0 0
0 0 0 0 0 0 0 0 0 0 0
0 0 0 0 0 0 0 0 0 0 0
0 0 0 0 0 0 0 0 0 0 0
0 0 0 0 0 0 0 0 0 0 0
0 0 0 0 0 0 0 0 0 0 0
0 0 0 0 0 0 0 0 0 0 0
0 0 0 0 0 0 0 0 0 0 0
0 0 0 0 0 0 0 0 0 0 0
0 0 0 0 0 0 0 0 0 0 0
0 0 0 0 0 0 0 0 0 0 0
0 0 0 0 0 0 0 0 0 0 0
0 0 0 0 0 0 0 0 0 0 0
0 0 0 0 0 0 0 0 0 0 0
0 0 0 0 0 0 0 0 0 0 0
0 0 0 0 0 0 0 0 0 0 0
0 0 0 0 0 0 0 0 0 0 0
0 0 0 0 0 0 0 0 0 0 0
0 0 0 0 0 0 0 0 0 0 0