MODE 2
SIZE 11/70
LIMIT 0/23
COLOR LIMIT 5
STARS 1000/5900/8600
POWERUPS 0/0/0/0
0 6 0 0 6 0 0 6 0 0 6
6 6 17 6 6 17 6 6 17 6 6
7 6 2 2 6 2 2 8 2 2 6
3 3 12 3 3 6 3 3 6 3 3
0 0 6 6 17 6 6 17 6 6 0
1 1 6 1 1 15 1 1 6 1 1
0 11 5 5 8 5 5 6 5 5 11
6 6 17 7 7 17 6 6 17 6 6
6 6 2 2 13 2 2 8 2 2 6
3 3 6 3 3 6 3 3 12 3 3
0 0 6 6 17 6 6 17 6 6 0
1 1 15 1 1 6 1 1 6 1 1
0 6 5 5 8 5 5 6 5 5 6
6 6 17 6 6 17 6 6 17 6 6
0 6 2 2 6 2 2 8 2 2 7
3 3 12 3 3 7 3 3 7 3 3
6 6 6 6 17 6 6 17 6 6 0
1 1 7 1 1 7 1 1 15 1 1
0 11 5 5 8 5 5 7 5 5 11
6 6 17 6 6 17 6 6 17 6 6
0 0 0 0 0 0 0 0 0 0 0
0 0 0 0 0 0 0 0 0 0 0
0 0 0 0 0 0 0 0 0 0 0
0 0 0 0 0 0 0 0 0 0 0
0 0 0 0 0 0 0 0 0 0 0
0 0 0 0 0 0 0 0 0 0 0
0 0 0 0 0 0 0 0 0 0 0
0 0 0 0 0 0 0 0 0 0 0
0 0 0 0 0 0 0 0 0 0 0
0 0 0 0 0 0 0 0 0 0 0
0 0 0 0 0 0 0 0 0 0 0
0 0 0 0 0 0 0 0 0 0 0
0 0 0 0 0 0 0 0 0 0 0
0 0 0 0 0 0 0 0 0 0 0
0 0 0 0 0 0 0 0 0 0 0
0 0 0 0 0 0 0 0 0 0 0
0 0 0 0 0 0 0 0 0 0 0
0 0 0 0 0 0 0 0 0 0 0
0 0 0 0 0 0 0 0 0 0 0
0 0 0 0 0 0 0 0 0 0 0
0 0 0 0 0 0 0 0 0 0 0
0 0 0 0 0 0 0 0 0 0 0
0 0 0 0 0 0 0 0 0 0 0
0 0 0 0 0 0 0 0 0 0 0
0 0 0 0 0 0 0 0 0 0 0
0 0 0 0 0 0 0 0 0 0 0
0 0 0 0 0 0 0 0 0 0 0
0 0 0 0 0 0 0 0 0 0 0
0 0 0 0 0 0 0 0 0 0 0
0 0 0 0 0 0 0 0 0 0 0
0 0 0 0 0 0 0 0 0 0 0
0 0 0 0 0 0 0 0 0 0 0
0 0 0 0 0 0 0 0 0 0 0
0 0 0 0 0 0 0 0 0 0 0
0 0 0 0 0 0 0 0 0 0 0
0 0 0 0 0 0 0 0 0 0 0
0 0 0 0 0 0 0 0 0 0 0
0 0 0 0 0 0 0 0 0 0 0
0 0 0 0 0 0 0 0 0 0 0
0 0 0 0 0 0 0 0 0 0 0
0 0 0 0 0 0 0 0 0 0 0
0 0 0 0 0 0 0 0 0 0 0
0 0 0 0 0 0 0 0 0 0 0
0 0 0 0 0 0 0 0 0 0 0
0 0 0 0 0 0 0 0 0 0 0
0 0 0 0 0 0 0 0 0 0 0
0 0 0 0 0 0 0 0 0 0 0
0 0 0 0 0 0 0 0 0 0 0
0 0 0 0 0 0 0 0 0 0 0
0 0 0 0 0 0 0 0 0 0 0