MODE 2
SIZE 11/70
LIMIT 0/25
COLOR LIMIT 4
STARS 900/2300/5400
POWERUPS 0/0/0/0
10 6 6 6 6 6 6 6 6 6 17
17 6 6 6 0 0 6 6 6 6 17
17 6 11 6 0 6 0 6 11 6 17
17 6 6 6 6 6 6 6 6 6 17
17 6 6 6 0 7 0 6 6 6 10
17 6 6 6 0 0 6 6 6 6 17
17 6 6 12 6 6 6 6 13 6 17
17 6 6 6 0 0 6 6 6 6 17
17 6 6 6 0 6 0 6 6 6 17
10 6 6 6 6 6 6 6 6 6 17
17 6 6 6 0 6 0 6 6 6 17
17 6 12 6 0 0 6 6 13 6 17
17 6 6 6 6 0 6 6 6 6 17
17 6 6 6 6 6 6 6 6 18 0
0 18 0 6 6 6 6 6 0 18 0
0 18 0 6 6 14 6 0 18 0 0
0 0 18 0 6 6 6 0 18 0 0
0 0 18 0 6 6 0 18 0 0 0
0 0 0 18 0 0 0 18 0 0 0
0 0 0 18 18 18 18 0 0 0 0
0 0 0 0 0 0 0 0 0 0 0
0 0 0 0 0 0 0 0 0 0 0
0 0 0 0 0 0 0 0 0 0 0
0 0 0 0 0 0 0 0 0 0 0
0 0 0 0 0 0 0 0 0 0 0
0 0 0 0 0 0 0 0 0 0 0
0 0 0 0 0 0 0 0 0 0 0
0 0 0 0 0 0 0 0 0 0 0
0 0 0 0 0 0 0 0 0 0 0
0 0 0 0 0 0 0 0 0 0 0
0 0 0 0 0 0 0 0 0 0 0
0 0 0 0 0 0 0 0 0 0 0
0 0 0 0 0 0 0 0 0 0 0
0 0 0 0 0 0 0 0 0 0 0
0 0 0 0 0 0 0 0 0 0 0
0 0 0 0 0 0 0 0 0 0 0
0 0 0 0 0 0 0 0 0 0 0
0 0 0 0 0 0 0 0 0 0 0
0 0 0 0 0 0 0 0 0 0 0
0 0 0 0 0 0 0 0 0 0 0
0 0 0 0 0 0 0 0 0 0 0
0 0 0 0 0 0 0 0 0 0 0
0 0 0 0 0 0 0 0 0 0 0
0 0 0 0 0 0 0 0 0 0 0
0 0 0 0 0 0 0 0 0 0 0
0 0 0 0 0 0 0 0 0 0 0
0 0 0 0 0 0 0 0 0 0 0
0 0 0 0 0 0 0 0 0 0 0
0 0 0 0 0 0 0 0 0 0 0
0 0 0 0 0 0 0 0 0 0 0
0 0 0 0 0 0 0 0 0 0 0
0 0 0 0 0 0 0 0 0 0 0
0 0 0 0 0 0 0 0 0 0 0
0 0 0 0 0 0 0 0 0 0 0
0 0 0 0 0 0 0 0 0 0 0
0 0 0 0 0 0 0 0 0 0 0
0 0 0 0 0 0 0 0 0 0 0
0 0 0 0 0 0 0 0 0 0 0
0 0 0 0 0 0 0 0 0 0 0
0 0 0 0 0 0 0 0 0 0 0
0 0 0 0 0 0 0 0 0 0 0
0 0 0 0 0 0 0 0 0 0 0
0 0 0 0 0 0 0 0 0 0 0
0 0 0 0 0 0 0 0 0 0 0
0 0 0 0 0 0 0 0 0 0 0
0 0 0 0 0 0 0 0 0 0 0
0 0 0 0 0 0 0 0 0 0 0
0 0 0 0 0 0 0 0 0 0 0
0 0 0 0 0 0 0 0 0 0 0
0 0 0 0 0 0 0 0 0 0 0