MODE 2
SIZE 11/70
LIMIT 0/26
COLOR LIMIT 4
STARS 1200/7000/13000
POWERUPS 0/0/0/0
1 1 1 1 6 6 6 6 6 6 6
1 10 1 1 6 7 0 0 0 0 0
1 1 1 1 18 6 7 0 0 0 0
0 0 0 6 8 6 7 1 1 1 1
0 0 0 0 6 18 6 1 1 12 1
0 0 0 6 6 18 6 1 1 1 1
2 2 2 2 6 18 6 0 0 0 0
2 2 12 2 18 6 0 0 0 0 0
2 2 2 2 18 6 0 0 0 0 0
0 0 6 6 8 7 7 2 2 2 2
0 0 0 6 6 18 7 2 11 2 2
0 0 0 6 6 18 7 2 2 2 2
5 5 5 5 6 6 18 0 0 0 0
5 5 15 5 6 18 0 0 0 0 0
5 5 5 5 6 18 0 0 0 0 0
0 0 6 6 18 6 6 5 5 5 5
0 0 0 6 6 18 6 5 14 5 5
0 0 0 6 6 18 6 5 5 5 5
3 3 3 6 6 6 8 6 7 0 0
3 3 12 3 6 18 6 6 0 0 0
3 3 3 3 6 18 6 6 0 0 0
0 0 6 6 18 6 6 3 3 3 3
0 0 0 6 6 18 6 3 12 3 3
0 0 0 6 6 18 6 3 3 3 3
0 0 0 0 0 0 0 0 0 0 0
0 0 0 0 0 0 0 0 0 0 0
0 0 0 0 0 0 0 0 0 0 0
0 0 0 0 0 0 0 0 0 0 0
0 0 0 0 0 0 0 0 0 0 0
0 0 0 0 0 0 0 0 0 0 0
0 0 0 0 0 0 0 0 0 0 0
0 0 0 0 0 0 0 0 0 0 0
0 0 0 0 0 0 0 0 0 0 0
0 0 0 0 0 0 0 0 0 0 0
0 0 0 0 0 0 0 0 0 0 0
0 0 0 0 0 0 0 0 0 0 0
0 0 0 0 0 0 0 0 0 0 0
0 0 0 0 0 0 0 0 0 0 0
0 0 0 0 0 0 0 0 0 0 0
0 0 0 0 0 0 0 0 0 0 0
0 0 0 0 0 0 0 0 0 0 0
0 0 0 0 0 0 0 0 0 0 0
0 0 0 0 0 0 0 0 0 0 0
0 0 0 0 0 0 0 0 0 0 0
0 0 0 0 0 0 0 0 0 0 0
0 0 0 0 0 0 0 0 0 0 0
0 0 0 0 0 0 0 0 0 0 0
0 0 0 0 0 0 0 0 0 0 0
0 0 0 0 0 0 0 0 0 0 0
0 0 0 0 0 0 0 0 0 0 0
0 0 0 0 0 0 0 0 0 0 0
0 0 0 0 0 0 0 0 0 0 0
0 0 0 0 0 0 0 0 0 0 0
0 0 0 0 0 0 0 0 0 0 0
0 0 0 0 0 0 0 0 0 0 0
0 0 0 0 0 0 0 0 0 0 0
0 0 0 0 0 0 0 0 0 0 0
0 0 0 0 0 0 0 0 0 0 0
0 0 0 0 0 0 0 0 0 0 0
0 0 0 0 0 0 0 0 0 0 0
0 0 0 0 0 0 0 0 0 0 0
0 0 0 0 0 0 0 0 0 0 0
0 0 0 0 0 0 0 0 0 0 0
0 0 0 0 0 0 0 0 0 0 0
0 0 0 0 0 0 0 0 0 0 0
0 0 0 0 0 0 0 0 0 0 0
0 0 0 0 0 0 0 0 0 0 0
0 0 0 0 0 0 0 0 0 0 0
0 0 0 0 0 0 0 0 0 0 0
0 0 0 0 0 0 0 0 0 0 0