MODE 2
SIZE 11/70
LIMIT 0/19
COLOR LIMIT 3
STARS 1000/2700/4200
POWERUPS 0/0/0/0
6 6 6 6 5 5 5 6 6 6 6
4 4 4 13 5 5 6 3 3 3 0
4 4 4 4 16 14 16 3 3 3 3
6 6 6 5 5 5 5 5 6 6 6
0 0 0 0 1 5 3 0 0 0 0
0 0 0 0 1 3 0 0 0 0 0
0 0 0 0 17 17 17 0 0 0 0
0 0 0 0 7 7 0 0 0 0 0
0 0 0 0 2 5 1 0 0 0 0
0 0 0 2 6 6 1 0 0 0 0
0 0 0 0 2 15 1 0 0 0 0
0 0 0 2 6 6 1 0 0 0 0
0 0 0 0 2 5 1 0 0 0 0
0 0 0 2 6 6 1 0 0 0 0
0 0 0 0 2 5 1 0 0 0 0
0 0 5 5 6 6 5 5 0 0 0
0 0 0 5 4 13 4 5 0 0 0
0 0 0 5 4 4 5 0 0 0 0
0 0 0 0 6 6 6 0 0 0 0
0 0 5 5 6 6 5 5 0 0 0
0 0 0 5 4 13 4 5 0 0 0
0 0 0 5 4 4 5 0 0 0 0
0 0 0 0 6 6 6 0 0 0 0
0 0 0 0 0 0 0 0 0 0 0
0 0 0 0 0 0 0 0 0 0 0
0 0 0 0 0 0 0 0 0 0 0
0 0 0 0 0 0 0 0 0 0 0
0 0 0 0 0 0 0 0 0 0 0
0 0 0 0 0 0 0 0 0 0 0
0 0 0 0 0 0 0 0 0 0 0
0 0 0 0 0 0 0 0 0 0 0
0 0 0 0 0 0 0 0 0 0 0
0 0 0 0 0 0 0 0 0 0 0
0 0 0 0 0 0 0 0 0 0 0
0 0 0 0 0 0 0 0 0 0 0
0 0 0 0 0 0 0 0 0 0 0
0 0 0 0 0 0 0 0 0 0 0
0 0 0 0 0 0 0 0 0 0 0
0 0 0 0 0 0 0 0 0 0 0
0 0 0 0 0 0 0 0 0 0 0
0 0 0 0 0 0 0 0 0 0 0
0 0 0 0 0 0 0 0 0 0 0
0 0 0 0 0 0 0 0 0 0 0
0 0 0 0 0 0 0 0 0 0 0
0 0 0 0 0 0 0 0 0 0 0
0 0 0 0 0 0 0 0 0 0 0
0 0 0 0 0 0 0 0 0 0 0
0 0 0 0 0 0 0 0 0 0 0
0 0 0 0 0 0 0 0 0 0 0
0 0 0 0 0 0 0 0 0 0 0
0 0 0 0 0 0 0 0 0 0 0
0 0 0 0 0 0 0 0 0 0 0
0 0 0 0 0 0 0 0 0 0 0
0 0 0 0 0 0 0 0 0 0 0
0 0 0 0 0 0 0 0 0 0 0
0 0 0 0 0 0 0 0 0 0 0
0 0 0 0 0 0 0 0 0 0 0
0 0 0 0 0 0 0 0 0 0 0
0 0 0 0 0 0 0 0 0 0 0
0 0 0 0 0 0 0 0 0 0 0
0 0 0 0 0 0 0 0 0 0 0
0 0 0 0 0 0 0 0 0 0 0
0 0 0 0 0 0 0 0 0 0 0
0 0 0 0 0 0 0 0 0 0 0
0 0 0 0 0 0 0 0 0 0 0
0 0 0 0 0 0 0 0 0 0 0
0 0 0 0 0 0 0 0 0 0 0
0 0 0 0 0 0 0 0 0 0 0
0 0 0 0 0 0 0 0 0 0 0
0 0 0 0 0 0 0 0 0 0 0