MODE 2
SIZE 11/70
LIMIT 0/21
COLOR LIMIT 5
STARS 900/4200/6200
POWERUPS 0/0/0/0
0 6 6 0 6 6 6 0 6 6 0
6 8 6 0 6 6 0 6 11 6 0
0 6 6 0 6 10 6 0 6 6 0
6 6 6 0 6 6 0 6 6 6 0
0 6 6 0 6 12 6 0 6 6 0
6 15 6 0 6 6 6 6 8 6 0
0 6 6 0 6 6 6 0 6 6 6
6 6 6 0 6 6 0 6 6 6 0
0 6 6 0 6 10 6 0 6 6 0
6 8 6 0 6 6 0 6 6 6 0
0 6 6 0 6 6 6 0 6 6 0
6 6 6 0 6 6 0 6 6 6 0
0 0 6 11 6 0 6 6 6 0 0
0 0 6 6 0 0 6 6 0 0 0
0 0 6 6 6 10 6 6 6 0 0
0 0 12 6 0 0 6 6 0 0 0
0 0 6 6 6 17 6 8 6 0 0
0 0 6 6 0 0 6 6 0 0 0
0 0 6 6 6 10 6 6 6 0 0
0 0 6 6 0 0 6 6 0 0 0
0 0 6 8 6 17 6 6 6 0 0
0 0 0 0 0 0 0 0 0 0 0
0 0 0 0 0 0 0 0 0 0 0
0 0 0 0 0 0 0 0 0 0 0
0 0 0 0 0 0 0 0 0 0 0
0 0 0 0 0 0 0 0 0 0 0
0 0 0 0 0 0 0 0 0 0 0
0 0 0 0 0 0 0 0 0 0 0
0 0 0 0 0 0 0 0 0 0 0
0 0 0 0 0 0 0 0 0 0 0
0 0 0 0 0 0 0 0 0 0 0
0 0 0 0 0 0 0 0 0 0 0
0 0 0 0 0 0 0 0 0 0 0
0 0 0 0 0 0 0 0 0 0 0
0 0 0 0 0 0 0 0 0 0 0
0 0 0 0 0 0 0 0 0 0 0
0 0 0 0 0 0 0 0 0 0 0
0 0 0 0 0 0 0 0 0 0 0
0 0 0 0 0 0 0 0 0 0 0
0 0 0 0 0 0 0 0 0 0 0
0 0 0 0 0 0 0 0 0 0 0
0 0 0 0 0 0 0 0 0 0 0
0 0 0 0 0 0 0 0 0 0 0
0 0 0 0 0 0 0 0 0 0 0
0 0 0 0 0 0 0 0 0 0 0
0 0 0 0 0 0 0 0 0 0 0
0 0 0 0 0 0 0 0 0 0 0
0 0 0 0 0 0 0 0 0 0 0
0 0 0 0 0 0 0 0 0 0 0
0 0 0 0 0 0 0 0 0 0 0
0 0 0 0 0 0 0 0 0 0 0
0 0 0 0 0 0 0 0 0 0 0
0 0 0 0 0 0 0 0 0 0 0
0 0 0 0 0 0 0 0 0 0 0
0 0 0 0 0 0 0 0 0 0 0
0 0 0 0 0 0 0 0 0 0 0
0 0 0 0 0 0 0 0 0 0 0
0 0 0 0 0 0 0 0 0 0 0
0 0 0 0 0 0 0 0 0 0 0
0 0 0 0 0 0 0 0 0 0 0
0 0 0 0 0 0 0 0 0 0 0
0 0 0 0 0 0 0 0 0 0 0
0 0 0 0 0 0 0 0 0 0 0
0 0 0 0 0 0 0 0 0 0 0
0 0 0 0 0 0 0 0 0 0 0
0 0 0 0 0 0 0 0 0 0 0
0 0 0 0 0 0 0 0 0 0 0
0 0 0 0 0 0 0 0 0 0 0
0 0 0 0 0 0 0 0 0 0 0
0 0 0 0 0 0 0 0 0 0 0